的	nfz	nfz
了	tll	tll
我	hqg	hqg
你	mqh	mqh
是	dhf	dhf
啊	jfx	jfx
不	jbb	jbb
有	uvy	uvy
都	afe	afe
在	ua	ua
就	chd	chd
也	dyy	dyy
好	gui	gui
人	kr	kr
吧	jo	jo
说	ivk	ivk
这	cod	cod
他	mdy	mdy
很	kmg	kmg
要	ugn	ugn
吗	jrm	jrm
去	aos	aos
还	jod	jod
和	wjk	wjk
看	hfm	hfm
会	kty	kty
没	ots	ots
想	sfn	sfn
呢	jnw	jnw
那	whf	whf
么	aos	aos
能	ovw	ovw
给	ygh	ygh
转	ptz	ptz
上	iss	iss
来	psb	psb
对	ruc	ruc
个	kcs	kcs
多	xxx	xxx
到	gpd	gpd
吃	jtw	jtw
做	mxl	mxl
过	uod	uod
被	lzp	lzp
又	ryy	ryy
让	iis	iis
太	kzd	kzd
最	dfr	dfr
她	gdy	gdy
爱	iur	iur
用	eyy	eyy
把	hob	hob
啦	jhk	jhk
大	kdd	kdd
小	hxx	hxx
得	kbu	kbu
才	uap	uap
谁	iru	iru
着	ifm	ifm
跟	emg	emg
一	eii	eii
再	nat	nat
中	roo	roo
哦	jhq	jhq
买	wfk	wfk
呀	jay	jay
里	mll	mll
真	ntb	ntb
下	ehb	ehb
图	glf	glf
找	hqg	hqg
叫	jc	jc
但	mbd	mbd
比	xbb	xbb
年	tay	tay
月	vyy	vyy
们	mem	mem
请	iqv	iqv
嘛	jxc	jxc
走	doo	doo
为	ziz	ziz
后	wme	wme
点	lxh	lxh
更	pgg	pgg
像	mzx	mzx
男	bil	bil
等	kws	kws
求	iqq	iqq
嗯	jgn	jgn
只	jt	jt
死	xwb	xwb
事	mxv	mxv
话	ifs	ifs
与	ewe	ewe
它	lwb	lwb
笑	kmt	kmt
从	kkr	kkr
老	awb	awb
当	dow	dow
快	nak	nak
逼	mbo	mbo
啥	jkf	jkf
完	ltk	ltk
玩	vtk	vtk
打	hrd	hrd
女	gnn	gnn
时	duc	duc
哪	jwf	jwf
懂	nbm	nbm
问	ejk	ejk
挺	hvo	hvo
而	hee	hee
别	jip	jip
听	jlj	jlj
新	ksl	ksl
拍	hnb	hnb
出	jgk	jgk
您	mqn	mqn
前	sv	sv
天	mt	mt
亲	ksm	ksm
可	xkk	xkk
哇	jvg	jvg
高	cgg	cgg
发	jry	jry
带	yzj	yzj
心	nxx	nxx
钱	teq	teq
美	ikd	ikd
睡	fxt	fxt
穿	ray	ray
写	cee	cee
哎	jbh	jbh
长	icc	icc
地	ady	ady
靠	fjp	fjp
先	fke	fke
猫	pbb	pbb
见	ejj	ejj
该	iph	iph
开	ckk	ckk
日	dr	dr
哥	xxk	xxk
刚	ghp	ghp
拿	ghs	ghs
哈	jgh	jgh
成	iwe	iwe
之	bii	bii
恩	gkn	gkn
总	vnx	vnx
却	aoc	aoc
家	lrs	lrs
住	mzv	mzv
阿	fxk	fxk
号	jek	jek
傻	msl	msl
回	dhh	dhh
无	cuu	cuu
已	aii	aii
喵	jbb	jbb
滴	okx	okx
牛	fnn	fnn
神	lds	lds
哭	dpq	dpq
萌	bdv	bdv
喝	jdp	jdp
越	diu	diu
水	iss	iss
张	iic	iic
加	ijk	ijk
花	bmw	bmw
分	tpd	tpd
帮	qfz	qfz
怕	nnb	nnb
黑	shh	shh
卖	uwk	uwk
额	lot	lot
鸡	rzn	rzn
字	lui	lui
连	pod	pod
二	tee	tee
路	eog	eog
学	dui	dui
换	hqk	hqk
搞	hcg	hcg
早	dus	dus
狗	psj	psj
妈	grm	grm
岁	exx	exx
少	hap	hap
干	kgg	kgg
送	smo	smo
将	yxu	yxu
生	nss	nss
跑	efo	efo
难	rru	rru
书	wwz	wwz
唉	jov	jov
倒	mgp	mgp
贴	qla	qla
脸	vgd	vgd
手	hss	hss
算	kfb	kfb
放	ylx	ylx
拉	hkl	hkl
祝	ljk	ljk
版	ywr	ywr
画	ebg	ebg
错	tud	tud
爆	xdi	xdi
起	daj	daj
三	oss	oss
行	pxx	pxx
以	wkr	wkr
猜	pqv	pqv
毛	emm	emm
纸	yyv	yyv
于	eus	eus
变	qry	qry
并	sck	sck
儿	kee	kee
敢	wfl	wfl
装	yay	yay
内	rnn	rnn
向	sjk	sjk
丝	yys	yys
帅	pzj	pzj
呗	jqb	jqb
掉	hhu	hhu
擦	hll	hll
姐	gkq	gkq
梦	cxx	cxx
特	fws	fws
粉	dtp	dtp
冷	frl	frl
车	pcc	pcc
陪	fkj	fkj
坐	kka	kka
每	tnm	tnm
假	mnr	mnr
超	dma	dma
咯	jog	jog
站	kla	kla
肉	rkr	rkr
谱	isd	isd
星	dns	dns
咋	jra	jra
够	sxx	sxx
金	tjj	tjj
肿	vro	vro
或	qme	qme
讲	iwj	iwj
煮	axh	axh
正	bee	bee
累	bys	bys
白	nbb	nbb
微	kbj	kbj
教	aul	aul
哟	jyz	jyz
本	sei	sei
照	dmx	dmx
第	kq	kq
全	kvw	kvw
弄	vbc	vbc
进	wod	wod
读	iuk	iuk
马	rmm	rmm
胖	vsh	vsh
飞	wfb	wfb
活	ofs	ofs
俩	mek	mek
唱	jdd	jdd
信	miy	miy
头	fkd	fkd
子	uii	uii
米	dmm	dmm
差	ieg	ieg
瘦	uyr	uyr
所	zlj	zlj
蛮	qcc	qcc
红	yeg	yeg
腿	vmo	vmo
王	vw	vw
同	gme	gme
某	ysm	ysm
咩	jiy	jiy
选	fko	fko
黄	ugy	ugy
若	buy	buy
热	hmx	hmx
久	qzd	qzd
骂	drm	drm
抱	hfo	hfo
卡	ihb	ihb
聊	fym	fym
些	jwt	jwt
忙	npw	npw
远	tko	tko
疼	ulf	ulf
网	ghh	ghh
噢	jsk	jsk
鸟	znn	znn
苦	bxg	bxg
主	zvw	zvw
如	gjk	gjk
自	dii	dii
卤	lhi	lhi
俺	mku	mku
养	izn	izn
店	xla	xla
强	ijc	ijc
者	aee	aee
富	lmb	lmb
忘	pnx	pnx
非	pff	pff
考	aek	aek
万	epd	epd
贵	cq	cq
喔	jng	jng
重	xml	xml
收	clx	clx
通	oeo	oeo
饿	whq	whq
次	fnq	fnq
约	yfz	yfz
包	fos	fos
亮	cbj	cbj
歌	xxn	xxn
型	cpa	cpa
种	wro	wro
蛋	hcc	hcc
风	bhi	bhi
面	tmm	tmm
低	myz	myz
君	oaj	oaj
元	tke	tke
追	ado	ado
赢	pjq	pjq
妹	gpw	gpw
破	uzp	uzp
此	jwb	jwb
贱	qeq	qeq
饭	wwr	wwr
火	xhh	xhh
摩	xch	xch
球	viq	viq
坏	ajb	ajb
李	sui	sui
赞	fkq	fkq
其	oqq	oqq
呆	jsm	jsm
另	jil	jil
挂	hvg	hvg
吓	jeh	jeh
系	ays	ays
秒	wha	wha
晒	dux	dux
海	otn	otn
羯	idp	idp
离	phr	phr
德	kun	kun
跳	ekf	ekf
谈	ixx	ixx
度	xur	xur
木	smm	smm
团	gua	gua
鱼	zvv	zvv
受	iry	iry
山	ess	ess
乱	fwe	fwe
力	ill	ill
斯	olj	olj
骗	rzy	rzy
疯	ubh	ubh
两	erk	erk
弱	iff	iff
菜	bic	bic
翻	ibn	ibn
巴	obb	obb
猪	pae	pae
情	nqv	nqv
咱	jdi	jdi
条	lsm	lsm
刷	nzp	nzp
感	imn	imn
按	hlg	hlg
西	uxx	uxx
恨	nmg	nmg
脚	vac	vac
留	ybt	ybt
呃	jwc	jwc
偶	mbr	mbr
晚	dz	dz
办	itb	itb
练	yvh	yvh
楼	sdg	sdg
定	lhf	lhf
雨	rvv	rvv
改	alx	alx
安	lgn	lgn
双	rss	rss
台	ojk	ojk
抢	hkc	hkc
组	ykq	ykq
道	sdo	sdo
愿	wnn	wnn
杀	hsm	hsm
洗	ofk	ofk
吐	jat	jat
哒	jko	jko
门	emm	emm
宫	ljj	ljj
喂	jby	jby
噗	jnz	jnz
闹	epz	epz
伤	mti	mti
处	lhb	lhb
耶	ffe	ffe
表	qyi	qyi
秀	wvn	wvn
曾	vdr	vdr
坑	apb	apb
急	qon	qon
乃	vnn	vnn
边	iod	iod
郑	smf	smf
报	hcr	hcr
撸	hzd	hzd
躺	gdj	gdj
呐	jrn	jrn
罗	cxx	cxx
往	kzv	kzv
国	glv	glv
哼	jct	jct
性	nns	nns
片	ypp	ypp
蓝	bpc	bpc
喷	juq	juq
机	sbj	sbj
陈	fvh	fvh
党	djk	djk
八	tbb	tbb
配	zaj	zaj
管	kld	kld
丫	scs	scs
外	xhb	xhb
克	xke	xke
达	kod	kod
法	oao	oao
树	sru	sru
招	hma	hma
爹	thx	thx
口	jkk	jkk
城	aiw	aiw
入	krr	krr
云	tyy	tyy
抓	hau	hau
盘	lcm	lcm
药	byz	byz
周	gqj	gqj
丢	vos	vos
光	dlu	dlu
货	mwq	mwq
屎	ndm	ndm
油	ogy	ogy
病	uer	uer
滚	oyo	oyo
林	cll	cll
悲	pnx	pnx
乐	yhx	yhx
尔	qhx	qhx
词	iwm	iwm
捏	hml	hml
相	sfm	sfm
催	mer	mer
晕	dcp	dcp
五	vuu	vuu
四	css	css
叔	ihr	ihr
丑	wat	wat
切	vpd	vpd
痛	uoe	uoe
顶	rty	rty
吹	jnq	jnq
因	gkd	gkd
近	lod	lod
名	xjk	xjk
嘴	jjq	jjq
戴	uqt	uqt
删	ypd	ypd
抽	hgy	hgy
气	tqq	tqq
块	aak	aak
怪	nra	nra
各	ogg	ogg
瞎	flj	flj
件	mfn	mfn
半	shs	shs
雷	rbt	rbt
作	mra	mra
吖	jsc	jsc
混	odx	odx
便	mpg	mpg
班	vpv	vpv
象	zxx	zxx
博	utu	utu
唔	jvj	jvj
银	tmg	tmg
未	pww	pww
摸	hlm	hlm
纯	yej	yej
常	djz	djz
深	ocs	ocs
短	vad	vad
文	cww	cww
咬	jfh	jfh
线	yeq	yeq
试	iqe	iqe
搜	hyr	hyr
直	nii	nii
指	hwd	hwd
雪	row	row
几	bjj	bjj
呦	jyi	jyi
尿	nis	nis
熊	ovx	ovx
毁	yet	yet
利	wpd	wpd
眼	fmg	fmg
动	til	til
样	siy	siy
明	dvy	dvy
奥	sdk	sdk
任	mvw	mvw
谢	igu	igu
塞	lwa	lwa
戳	nrq	nrq
色	qob	qob
段	hts	hts
皮	zpp	zpp
平	ksb	ksb
夜	pml	pml
虐	xow	xow
酒	ozy	ozy
香	wdr	wdr
刘	cpd	cpd
控	hre	hre
泡	ofo	ofo
床	xsm	xsm
空	reg	reg
鞋	zvg	zvg
命	gjc	gjc
化	mwb	mwb
爬	aob	aob
撒	hul	hul
由	gyy	gyy
波	ozp	ozp
爪	auu	auu
演	olg	olg
查	sbd	sbd
合	ghh	ghh
灰	uxh	uxh
宅	lav	lav
血	acm	acm
宝	llv	llv
则	qpd	qpd
粗	dkq	dkq
句	sjj	sjj
莫	lmm	lmm
诗	iws	iws
款	aln	aln
跪	eqc	eqc
类	dkd	dkd
关	smt	smt
孩	uph	uph
满	obk	obk
房	zyf	zyf
茶	bks	bks
操	hjs	hjs
土	att	att
凉	fch	fch
冲	fro	fro
流	otg	otg
语	ivj	ivj
喊	jim	jim
瓶	scm	scm
帖	zla	zla
整	plb	plb
背	ywv	ywv
部	kjf	kjf
身	gss	gss
队	fkr	fkr
科	wld	wld
爸	tho	tho
呵	jxk	jxk
爽	khh	khh
待	kws	kws
南	ugi	ugi
勒	zil	zil
友	ury	ury
斤	ljj	ljj
记	iaj	iaj
准	fru	fru
龙	zll	zll
输	pgp	pgp
草	bdu	bdu
单	vus	vus
拼	hsc	hsc
念	rwn	rwn
吴	jmt	jmt
华	mwu	mwu
清	oqv	oqv
臭	dpq	dpq
接	hkg	hkg
枪	skc	skc
汤	owi	owi
豆	add	add
魔	xco	xco
醒	zdn	zdn
票	uls	uls
断	dwl	dwl
刀	pdd	pdd
杨	swi	swi
杯	sjb	sjb
反	wry	wry
郭	cuf	cuf
介	knd	knd
理	vml	vml
间	edr	edr
题	dht	dht
及	rjj	rjj
烂	xso	xso
提	hdh	hdh
嘤	jqg	jqg
亿	mwi	mwi
群	oai	oai
数	dgl	dgl
渣	osb	osb
碗	ulc	ulc
胸	vfg	vfg
必	nap	nap
交	fhi	fhi
骑	rkx	rkx
根	smg	smg
方	yff	yff
布	uzj	uzj
篇	kzy	kzy
丁	rdd	rdd
狠	pmg	pmg
停	mcr	mcr
份	mtp	mtp
汗	okg	okg
尽	nzf	nzf
落	qog	qog
省	haf	haf
使	mmh	mmh
硬	upg	upg
传	mtz	mtz
季	wui	wui
欧	ahn	ahn
搭	hbg	hbg
且	kqq	kqq
左	ueg	ueg
握	hng	hng
区	ahi	ahi
暖	dar	dar
七	vqq	vqq
喽	jdg	jdg
潘	oib	oib
泪	ofm	ofm
烦	xty	xty
藏	bie	bie
素	qys	qys
基	oat	oat
尼	nwb	nwb
乖	xyw	xyw
挑	hkf	hkf
穷	ril	ril
春	qdr	qdr
至	gii	gii
修	mli	mli
街	pvg	pvg
北	ywb	ywb
棒	sqh	sqh
碎	upu	upu
挖	hrw	hrw
级	yrj	yrj
排	hpf	hpf
节	bcj	bcj
趣	dfr	dfr
派	owy	owy
慢	nqm	nqm
杜	sat	sat
觉	dej	dej
圆	gjq	gjq
六	fll	fll
知	vjk	vjk
式	qeg	qeg
牌	ygu	ygu
咔	jih	jih
桥	smn	smn
致	glx	glx
赚	qsn	qsn
救	ilx	ilx
补	lhb	lhb
虎	xbj	xbj
课	ibs	ibs
量	bml	bml
粑	dob	dob
绿	yoi	yoi
九	mjj	mjj
推	hru	hru
折	hlj	hlj
忍	pzn	pzn
插	hxy	hxy
剪	svp	svp
鬼	gos	gos
套	kic	kic
堪	aow	aow
立	kll	kll
师	pez	pez
兔	zkz	zkz
投	hts	hts
爷	thc	thc
摔	hpu	hpu
嫁	glr	glr
赛	lwq	lwq
借	mud	mud
称	wqh	wqh
扔	hvn	hvn
屁	nxb	nxb
戏	rqg	rqg
百	ubb	ubb
砸	uaz	uaz
租	wkq	wkq
惹	bun	bun
嗨	jon	jon
腰	vug	vug
胡	xvy	xvy
亦	qii	qii
肥	vob	vob
游	oyu	oyu
偷	mgp	mgp
懒	npq	npq
妞	gwa	gwa
桑	rrs	rrs
味	jpw	jpw
撞	hkm	hkm
费	inq	inq
甩	ewe	ewe
挤	hcn	hcn
墙	aad	aad
东	vhx	vhx
佛	min	min
原	wnh	wnh
羊	iyy	iyy
亚	eny	eny
奔	kub	kub
扯	hji	hji
场	awi	awi
糖	dxj	dxj
苏	bit	bit
蛇	clw	clw
卷	mcj	mcj
吉	qjj	qjj
座	xka	xka
淫	oav	oav
娶	frg	frg
堵	aae	aae
皆	xnb	xnb
赵	dhi	dhi
解	qpf	qpf
期	ovy	ovy
踢	edi	edi
底	xyz	xyz
韩	udh	udh
森	scl	scl
即	mcj	mcj
盖	icm	icm
散	uvl	uvl
江	oeg	oeg
瑟	vva	vva
槽	syd	syd
涨	oii	oii
笨	kse	kse
熟	cux	cux
齐	cnd	cnd
摆	hco	hco
替	mmd	mmd
喜	pjk	pjk
位	mkl	mkl
调	igq	igq
易	dfi	dfi
冰	fis	fis
应	xdd	xdd
十	uss	uss
拖	htd	htd
格	sog	sog
印	yec	yec
淡	oxx	oxx
嘿	jsh	jsh
嘞	jzi	jzi
剩	wyp	wyp
娘	gzm	gzm
凭	mvb	mvb
体	mse	mse
捡	hgd	hgd
偏	mzy	mzy
烧	xql	xql
痘	uad	uad
逛	pvo	pvo
旧	cdr	cdr
娃	gvg	gvg
升	abc	abc
恋	qnx	qnx
岛	zes	zes
鸭	gzn	gzn
甜	fyg	fyg
丽	evv	evv
咪	jdm	jdm
电	udd	udd
代	mqi	mqi
欲	cnq	cnq
史	jhi	jhi
寄	lkx	lkx
蝎	cdp	cdp
闲	esm	esm
既	mcu	mcu
狼	pzm	pzm
声	ans	ans
签	kgd	kgd
经	yre	yre
什	mus	mus
踩	eic	eic
辣	fps	fps
维	yru	yru
呜	jzu	jzu
减	fim	fim
公	tos	tos
躲	gbs	gbs
狂	pvw	pvw
静	qvx	qvx
首	sdi	sdi
灯	xrd	xrd
占	laa	laa
托	hav	hav
涂	okw	okw
奇	kxk	kxk
福	lmb	lmb
欠	nqq	nqq
烟	xgk	xgk
副	mbp	mbp
青	qvy	qvy
圈	gmc	gmc
烤	xae	xae
射	guc	guc
软	pnq	pnq
曼	qmm	qmm
遍	zyo	zyo
夏	tlx	tlx
撑	hdh	hdh
何	mxk	mxk
吵	jha	jha
望	pvv	pvv
搬	hlt	hlt
英	bgk	bgk
仔	mui	mui
脑	vpg	vpg
剧	nxp	nxp
抹	hpm	hpm
逗	aod	aod
犯	pcj	pcj
界	bkn	bkn
怎	rnx	rnx
论	ikw	ikw
集	rsm	rsm
沙	oha	oha
兰	sos	sos
牙	ayy	ayy
物	ffi	ffi
惨	noi	noi
压	waz	waz
缺	bak	bak
似	mwk	mwk
登	tad	tad
咦	jki	jki
截	uqr	uqr
食	wss	wss
拔	hur	hur
咧	jxp	jxp
器	dpd	dpd
归	pow	pow
舔	fmh	fmh
湿	odn	odn
窝	rjr	rjr
取	fry	fry
运	tod	tod
潮	ouv	ouv
朝	udv	udv
足	euu	euu
石	uss	uss
麦	qlx	qlx
塔	abg	abg
价	mkn	mkn
普	snd	snd
汪	ovw	ovw
歪	jbe	jbe
果	bsm	bsm
诺	ibu	ibu
衣	yii	yii
轻	pre	pre
退	mod	mod
结	yqj	yqj
嫌	gsn	gsn
薄	qtu	qtu
征	kbe	kbe
奶	gvn	gvn
症	ube	ube
奖	yxk	yxk
忒	qnx	qnx
夹	msb	msb
千	xqq	xqq
迷	dod	dod
炒	xha	xha
绝	yqo	yqo
随	fuo	fuo
古	xgg	xgg
船	lbj	lbj
帝	kzj	kzj
村	suc	suc
扣	hjk	hjk
岂	eaj	eaj
厚	wdu	wdu
母	nmm	nmm
铁	tam	tam
言	iyy	iyy
酸	zol	zol
细	ybt	ybt
习	nxx	nxx
粘	dla	dla
残	xeq	xeq
刑	cpd	cpd
晓	dql	dql
诚	iiw	iiw
郎	zmf	zmf
矮	vwg	vwg
露	reo	reo
军	cpc	cpc
右	uyy	uyy
证	ibe	ibe
梅	stn	stn
拆	hlz	hlz
湖	oxv	oxv
精	dqv	dqv
建	xoy	xoy
举	dth	dth
订	ird	ird
麽	xco	xco
田	btt	btt
范	qcj	qcj
市	pzj	pzj
战	lqg	lqg
碰	usn	usn
需	rhe	rhe
姓	gns	gns
甚	owe	owe
瞧	frx	frx
猛	puc	puc
嘉	pij	pij
服	vcr	vcr
码	urm	urm
值	mni	mni
导	ouc	ouc
抄	hha	hha
官	ldh	ldh
巨	aak	aak
叶	jus	jus
吊	jzj	jzj
泥	onw	onw
妆	ygn	ygn
毒	qnm	qnm
治	ooj	ooj
锅	tjr	tjr
脱	vvk	vvk
思	bnx	bnx
萨	bfw	bfw
冠	ctu	ctu
灭	exh	exh
仍	mvn	mvn
防	fyf	fyf
晨	dzc	dzc
吻	jfi	jfi
存	uui	uui
弹	ivu	ivu
品	jdh	jdh
扑	hhb	hhb
宇	leu	leu
宁	lrd	lrd
劝	ril	ril
迪	god	god
耍	hgn	hgn
洛	oog	oog
局	nwj	nwj
意	snx	snx
愁	wxn	wxn
赶	dkg	dkg
笔	kem	kem
音	syy	syy
冒	dfm	dfm
邮	gfe	gfe
影	xis	xis
蹭	evd	evd
霜	rsf	rsf
朱	apw	apw
婚	gyd	gyd
陆	fhg	fhg
驴	rzh	rzh
蟹	qpc	qpc
丹	gpp	gpp
峰	elq	elq
粮	dzm	dzm
扎	hwe	hwe
害	lqj	lqj
嫩	gpl	gpl
蒸	bwx	bwx
困	gsm	gsm
零	rrl	rrl
哄	jut	jut
炮	xfo	xfo
魂	tgo	tgo
现	vej	vej
艾	bhi	bhi
捉	heu	heu
河	oxk	oxk
紧	pry	pry
工	egg	egg
胜	vns	vns
终	ylf	ylf
播	hib	hib
隔	fug	fug
炸	xra	xra
封	vuc	vuc
孙	uhx	uhx
噶	jbp	jbp
劲	rei	rei
圣	rat	rat
炖	xej	xej
雾	rli	rli
唐	xxj	xxj
蹲	ezu	ezu
股	vts	vts
申	dss	dss
唯	jru	jru
透	wvo	wvo
威	ieg	ieg
然	vpx	vpx
劈	njp	njp
据	hnx	hnx
纳	yrn	yrn
酱	yxz	yxz
熬	qpx	qpx
遇	bro	bro
憋	wln	wln
醉	zpu	zpu
昂	dyc	dyc
舟	loo	loo
案	lgs	lgs
舞	tba	tba
酷	zfj	zfj
磨	xcu	xcu
令	rll	rll
玉	lvv	lvv
刮	fpd	fpd
野	mcv	mcv
割	lqp	lqp
答	kgh	kgh
冻	fvh	fvh
著	bae	bae
联	fsm	fsm
容	lcg	lcg
刺	npd	npd
客	log	log
互	eow	eow
贝	qbb	qbb
永	zis	zis
夫	mff	mff
蒂	bkz	bkz
宽	lbe	lbe
阳	fdr	fdr
吸	jrj	jrj
墨	sat	sat
板	swr	swr
较	pfh	pfh
初	lpd	lpd
冥	cdf	cdf
伊	moa	moa
编	yzy	yzy
针	tus	tus
略	bog	bog
菇	bgx	bgx
瓦	mww	mww
梁	ops	ops
伟	mhw	mhw
屋	ngi	ngi
率	pyu	pyu
智	vjd	vjd
观	rej	rej
己	ajj	ajj
世	uwe	uwe
秋	wxh	wxh
角	qjj	qjj
寸	ucc	ucc
贼	qqu	qqu
跌	eam	eam
佳	mvg	mvg
骚	rrc	rrc
伞	ksu	ksu
鼻	dbl	dbl
凶	hgk	hgk
具	ktb	ktb
夸	kee	kee
缘	yor	yor
园	gtk	gtk
湘	osf	osf
剑	gdp	gdp
曲	yqq	yqq
架	ijs	ijs
凑	fqm	fqm
淘	ofb	ofb
志	an	an
降	fla	fla
徐	kkw	kkw
瓜	agg	agg
弯	qig	qig
啃	jjv	jjv
民	bmm	bmm
纹	ycw	ycw
闪	ekr	ekr
泰	qis	qis
蒙	yer	yer
揍	hqm	hqm
飘	ulh	ulh
趁	dki	dki
遭	ydo	ydo
扒	htb	htb
守	luc	luc
帐	zic	zic
广	xgg	xgg
吾	vjk	vjk
轮	pkw	pkw
负	qqb	qqb
雅	aru	aru
仅	mry	mry
忧	ndy	ndy
暴	dui	dui
极	srj	srj
卧	ehb	ehb
孔	uwe	uwe
扫	how	how
盯	frd	frd
怒	grn	grn
共	utb	utb
灵	oxh	oxh
钻	tla	tla
造	fjo	fjo
恶	enn	enn
善	isj	isj
腻	vqq	vqq
嗷	jql	jql
沈	ock	ock
标	sls	sls
众	kkk	kkk
胃	bvy	bvy
许	itu	itu
步	jhx	jhx
盒	gcm	gcm
浪	ozm	ozm
瞅	fwx	fwx
罪	cpf	cpf
景	xjj	xjj
谷	cgg	cgg
麻	xcl	xcl
闻	efe	efe
恤	nac	nac
录	ois	ois
院	flk	flk
抠	hah	hah
紫	jwy	jwy
饼	wsc	wsc
肌	vbj	vbj
趴	etb	etb
付	muc	muc
叠	rrk	rrk
液	opl	opl
凤	bry	bry
堆	aru	aru
锁	tdq	tdq
败	qlx	qlx
耳	fee	fee
戒	qbc	qbc
顺	gty	gty
属	nar	nar
废	xjr	xjr
领	rty	rty
乳	auw	auw
揉	hcs	hcs
秤	wks	wks
睇	fsq	fsq
业	nyy	nyy
虽	jcc	jcc
寻	ouc	ouc
啰	jcx	jcx
独	pcc	pcc
吼	juw	juw
坨	alw	alw
甘	ygg	ygg
朵	bsm	bsm
显	dny	dny
凡	bzd	bzd
搓	hie	hie
馋	wzf	wzf
料	dld	dld
川	gcc	gcc
薇	bkb	bkb
康	xxi	xxi
寒	lwf	lwf
港	ouo	ouo
猿	pay	pay
翔	inv	inv
脏	vxa	vxa
狮	ppz	ppz
供	mut	mut
玛	vrm	vrm
钟	tro	tro
屏	nsc	nsc
除	fkw	fkw
优	mdy	mdy
权	sry	sry
姆	gnm	gnm
实	lfk	lfk
震	rzc	rzc
温	odc	odc
糗	ddp	ddp
冯	frm	frm
侠	mms	mms
赌	qae	qae
阴	fvy	fvy
今	rwe	rwe
捧	hqh	hqh
伯	mnb	mnb
州	dgc	dgc
含	rwj	rwj
备	lbt	lbt
虾	ceh	ceh
顿	ejt	ejt
壳	fbj	fbj
居	nxg	nxg
氏	yvq	yvq
员	jq	jq
评	iks	iks
伴	msh	msh
镇	tnt	tnt
耐	huc	huc
敲	cxd	cxd
洞	ogm	ogm
牵	kcf	kcf
罚	cip	cip
拜	heq	heq
摇	hab	hab
曹	ydr	ydr
攻	elx	elx
斗	ldd	ldd
绕	yql	yql
依	myi	myi
汉	ory	ory
馆	wld	wld
披	hzp	hzp
响	jsj	jsj
宗	lls	lls
染	oms	oms
董	bxm	bxm
掰	hth	hth
京	chx	chx
蠢	qdc	qdc
仙	mes	mes
届	ngy	ngy
呸	jje	jje
浓	ocy	ocy
松	sto	sto
敬	bsl	bsl
砍	unq	unq
兽	vme	vme
摄	hfr	hfr
腾	vmr	vmr
杰	sxh	sxh
否	jjk	jjk
虫	ccc	ccc
俊	mol	mol
武	eqj	eqj
免	zke	zke
争	qxv	qxv
袁	ajy	ajy
伐	mqg	mqg
复	tdl	tdl
莱	bps	bps
壮	yas	yas
制	fzp	fzp
保	mjs	mjs
蜜	lnc	lnc
咳	jph	jph
扇	znv	znv
萧	bxt	bxt
测	oqp	oqp
滑	odg	odg
埋	aml	aml
虚	xny	xny
帕	znb	znb
贪	rwq	rwq
妮	gnw	gnw
旺	dvw	dvw
盆	tpc	tpc
饱	wfo	wfo
妖	gmt	gmt
犬	pqq	pqq
巧	eek	eek
列	xpd	xpd
尾	nem	nem
甲	gjj	gjj
颗	bst	bst
膜	vlm	vlm
堂	dja	dja
密	lne	lne
哆	jxx	jxx
怀	njb	njb
捂	hvj	hvj
鲁	zdr	zdr
啪	jhn	jhn
商	ktj	ktj
宋	lsm	lsm
认	ikr	ikr
慌	nbg	nbg
捞	hyi	hyi
环	vjb	vjb
缩	ylu	ylu
粥	idi	idi
妙	gha	gha
骨	dgg	dgg
勿	fis	fis
展	nuy	nuy
继	ydw	ydw
失	amf	amf
晃	ddl	ddl
洋	oiy	oiy
章	sus	sus
铺	ttf	ttf
兵	ltb	ltb
镜	tsk	tsk
於	ykf	ykf
倍	mkj	mkj
挡	hdo	hdo
遮	xuo	xuo
室	lgi	lgi
财	qua	qua
漏	onr	onr
烫	owx	owx
税	wvk	wvk
溜	oyb	oyb
库	xpc	xpc
士	ass	ass
瑞	veh	veh
甄	uam	uam
豪	crs	crs
消	odv	odv
轰	prs	prs
仁	mte	mte
亏	eek	eek
浅	oeq	oeq
煎	svx	svx
沉	ocb	ocb
芙	bmf	bmf
抗	hpb	hpb
端	keh	keh
颜	kwt	kwt
顾	wct	wct
兄	jke	jke
龟	qud	qud
希	huz	huz
告	fjk	fjk
航	lpb	lpb
闷	enx	enx
健	mxo	mxo
盐	ahc	ahc
键	txo	txo
乔	mnd	mnd
伦	mkw	mkw
抛	hmi	hmi
窗	rsl	rsl
肯	jvy	jvy
寺	wss	wss
层	nty	nty
社	lat	lat
划	qpd	qpd
冬	lfb	lfb
碧	vnu	vnu
痒	uiy	uiy
裤	lxp	lxp
咸	ime	ime
围	ghw	ghw
尚	djk	djk
弃	tbc	tbc
档	sdo	sdo
支	ury	ury
获	bpp	bpp
嘎	jtq	jtq
识	ijt	ijt
菲	bpf	bpf
惊	nch	nch
漫	oqm	oqm
横	sug	sug
兴	dtb	dtb
餐	xrw	xrw
余	kwh	kwh
休	msm	msm
幅	zmb	zmb
敷	tyl	tyl
嬛	gcy	gcy
逆	sjo	sjo
怂	kkn	kkn
暗	dsy	dsy
垫	hma	hma
晴	dqv	dqv
串	rro	rro
娇	gmn	gmn
拌	hsh	hsh
稳	wqn	wqn
刻	ppd	ppd
视	lej	lej
页	tyy	tyy
悦	nvk	nvk
宠	lzl	lzl
炫	xpy	xpy
族	ytv	ytv
猴	pmv	pmv
膏	cvy	cvy
状	ypq	ypq
竟	ske	ske
填	ant	ant
剃	sqp	sqp
故	xlx	xlx
聚	fri	fri
逃	kfo	kfo
琴	vvw	vvw
燕	ujx	ujx
叼	jwe	jwe
形	cis	cis
腹	vtl	vtl
产	kwc	kwc
礼	lwe	lwe
泽	orh	orh
鼠	yss	yss
目	fmm	fmm
薛	baf	baf
私	wos	wos
赖	pqq	pqq
蔡	btl	btl
伪	mzz	mzz
欢	rnq	rnq
候	ma	ma
澡	ojs	ojs
桌	hds	hds
沾	ola	ola
拽	hda	hda
尖	hkd	hkd
侧	mqp	mqp
姑	gxg	gxg
凯	eab	eab
砖	utz	utz
胶	vfh	vfh
肾	prv	prv
曰	drr	drr
井	wjj	wjj
执	hmz	hmz
缠	yxm	yxm
侬	mcy	mcy
彭	pis	pis
祸	ljr	ljr
校	sfh	sfh
设	its	its
叹	jry	jry
彩	iis	iis
攒	hfq	hfq
驾	ijr	ijr
娜	gwf	gwf
旁	kyf	kyf
袋	mqy	mqy
霾	rpm	rpm
专	twz	twz
源	owh	owh
竹	kuu	kuu
挠	hql	hql
梗	spg	spg
厂	wcc	wcc
肺	vnc	vnc
蹦	eev	eev
功	eil	eil
舍	kfs	kfs
惯	nnq	nnq
泉	nis	nis
研	uck	uck
盼	ftp	ftp
译	irh	irh
漂	oul	oul
斜	kwl	kwl
稍	wdv	wdv
限	fmg	fmg
祖	lkq	lkq
俗	mcg	mcg
翘	qln	qln
赏	djq	djq
荷	bmx	bmx
柯	sxk	sxk
邓	rfe	rfe
尊	zuc	zuc
施	ytd	ytd
损	hjq	hjq
挣	hqx	hqx
严	enw	enw
贾	uqb	uqb
崔	eru	eru
扭	hwa	hwa
踹	eeh	eeh
抖	hld	hld
须	ity	ity
户	zhh	zhh
樱	sqg	sqg
宜	lkq	lkq
摘	hkx	hkx
稿	wcg	wcg
嘘	jxn	jxn
绳	yju	yju
蒋	byu	byu
赤	any	any
净	fqx	fqx
均	aff	aff
宏	luo	luo
衰	ygt	ygt
末	pmm	pmm
沃	omt	omt
计	ius	ius
般	lts	lts
蕾	brb	brb
坤	ads	ads
艺	bwi	bwi
移	wxx	wxx
持	hws	hws
赔	qkj	qkj
捐	hjv	hjv
童	kml	kml
县	kos	kos
撤	htl	htl
禁	cls	cls
始	goj	goj
趟	ddj	ddj
索	fys	fys
乘	wyw	wyw
距	eaa	eaa
政	blx	blx
歇	dfn	dfn
罐	bbr	bbr
医	avs	avs
裸	lbs	lbs
勇	oei	oei
弟	sqk	sqk
慧	qqn	qqn
捅	hoe	hoe
柳	sym	sym
欣	lnq	lnq
批	hxb	hxb
拒	haa	haa
塘	axj	axj
溪	oak	oak
胆	vbd	vbd
旅	yty	yty
逢	lqo	lqo
程	wjv	wjv
乡	yxx	yxx
醋	zud	zud
默	spq	spq
义	zhi	zhi
荣	ysm	ysm
撕	hol	hol
莉	bwp	bwp
糊	dxv	dxv
洪	out	out
僧	mvd	mvd
核	sph	sph
鲜	ziy	ziy
帽	zdf	zdf
鑫	ttt	ttt
贺	ijq	ijq
掐	hqy	hqy
悬	kon	kon
焦	rxh	rxh
硕	uty	uty
浮	oau	oau
兼	son	son
乌	zuu	zuu
采	icc	icc
沪	ozh	ozh
靓	qve	qve
坟	acw	acw
哩	jml	jml
尸	nss	nss
庆	xkd	xkd
莎	qha	qha
枰	sks	sks
皇	nvw	nvw
池	ody	ody
盛	iwc	iwc
挨	hov	hov
简	ked	ked
乎	asu	asu
芳	byf	byf
呼	jau	jau
扛	heg	heg
鼓	pur	pur
赫	ann	ann
珞	vog	vog
碟	uus	uus
充	tke	tke
哉	uqj	uqj
辞	ffx	ffx
仇	mmj	mmj
勾	fos	fos
跨	eke	eke
钢	tgh	tgh
拱	hut	hut
皂	nvq	nvq
侯	mav	mav
杂	msm	msm
啧	jne	jne
止	jii	jii
摊	hrr	hrr
钓	tfz	tfz
朗	zmv	zmv
仓	kcj	kcj
姜	ign	ign
苗	bbt	bbt
秦	qwh	qwh
隆	fln	fln
惠	tcn	tcn
判	shp	shp
引	ics	ics
搅	hde	hde
衫	lis	lis
剁	bsp	bsp
舒	kfc	kfc
啵	joz	joz
卸	bcj	bcj
葱	bfn	bfn
添	omh	omh
裙	loj	loj
扬	hwi	hwi
谦	isn	isn
嗦	jfy	jfy
扮	htp	htp
拨	hjr	hjr
勤	zti	zti
职	fjt	fjt
丸	mzd	mzd
盗	fnc	fnc
兹	syy	syy
蝶	cus	cus
曝	ddi	ddi
矣	ovs	ovs
莲	bpo	bpo
努	gri	gri
雄	uor	uor
稀	whz	whz
菊	bfd	bfd
临	pkd	pkd
嗲	jtx	jtx
沟	ofo	ofo
辆	pek	pek
湾	oqi	oqi
剥	oip	oip
宿	lmu	lmu
饮	wnq	wnq
桶	soe	soe
速	pod	pod
境	ask	ask
痣	uan	uan
扶	hmf	hmf
舌	fss	fss
糟	dyd	dyd
腐	xmk	xmk
忠	rnx	rnx
护	hzh	hzh
琪	voq	voq
熙	eox	eox
朕	vsm	vsm
术	szd	szd
闯	erm	erm
颠	ntt	ntt
幸	aiy	aiy
靴	zmw	zmw
陷	fqy	fqy
佩	mbz	mbz
酥	zwh	zwh
迟	nzo	nzo
孤	uag	uag
羞	iwa	iwa
棋	soq	soq
臀	nuv	nuv
父	thi	thi
绑	yqf	yqf
润	oev	oev
项	ety	ety
犹	pdy	pdy
魏	wgo	wgo
创	kcp	kcp
嚯	jrr	jrr
珊	vyc	vyc
庄	xat	xat
毕	xus	xus
肩	zvy	zvy
扁	zyc	zyc
裂	xpy	xpy
肚	vat	vat
禅	lvu	lvu
糕	dix	dix
附	fmu	fmu
旗	yto	yto
橙	sta	sta
汁	ous	ous
侃	mjg	mjg
枝	sur	sur
砂	uha	uha
纪	yaj	yaj
凹	gei	gei
唇	zjk	zjk
仨	mos	mos
枕	sck	sck
琳	vcl	vcl
邦	qfe	qfe
鲍	zfo	zfo
厄	wcj	wcj
磕	uac	uac
竖	prk	prk
邪	afe	afe
辩	fif	fif
孟	ucm	ucm
胎	voj	voj
迎	yco	yco
拳	mhs	mhs
箱	ksf	ksf
渡	oxr	oxr
拾	hgh	hgh
质	wuq	wuq
卢	hns	hns
挫	hka	hka
咖	jij	jij
卓	hdu	hdu
忌	anx	anx
叻	jil	jil
轴	pgy	pgy
拧	hlr	hlr
增	avd	avd
载	uqp	uqp
颇	zty	zty
榜	sky	sky
仲	mro	mro
嫂	gyr	gyr
嘻	jpj	jpj
搂	hdg	hdg
肠	vwi	vwi
嚼	jau	jau
詹	qwi	qwi
购	qfo	qfo
朴	shb	shb
助	kil	kil
锦	tnz	tnz
异	obc	obc
粽	dll	dll
宰	lfx	lfx
织	yjt	yjt
愣	ncy	ncy
敌	flx	flx
洁	oqj	oqj
穆	wni	wni
埃	aov	aov
咒	dbj	dbj
杆	skg	skg
庙	xgy	xgy
杠	seg	seg
途	kwo	kwo
敏	tnl	tnl
决	fak	fak
噜	jzd	jzd
吞	mjk	mjk
柔	csm	csm
鹏	vvz	vvz
珠	vap	vap
驻	rzv	rzv
柜	saa	saa
瞄	fbb	fbb
坎	anq	anq
剂	cnp	cnp
孝	aui	aui
斑	vcv	vcv
轩	pkg	pkg
黎	wfi	wfi
掌	djh	djh
抬	hoj	hoj
幂	cdz	cdz
黏	wkl	wkl
规	mej	mej
瑕	vnr	vnr
粪	dut	dut
肝	vkg	vkg
鹿	all	all
罢	cao	cao
辛	fxx	fxx
玮	vhw	vhw
弗	ind	ind
良	zmg	zmg
慎	nnt	nnt
臣	ecc	ecc
熏	xsh	xsh
缝	ylo	ylo
钗	trz	trz
崩	evv	evv
慕	lhx	lhx
积	wjt	wjt
赐	qdi	qdi
勺	fzd	fzd
姚	gkf	gkf
梨	wps	wps
喇	jpp	jpp
浩	ofj	ofj
谨	izt	izt
俄	mhq	mhq
芬	btp	btp
凌	fal	fal
坡	azp	azp
昌	ddr	ddr
颤	pdt	pdt
卫	cei	cei
嗒	jbg	jbg
洒	oux	oux
赠	qvd	qvd
农	cyi	cyi
芯	bnx	bnx
参	oki	oki
籽	dui	dui
霍	rru	rru
柴	jws	jws
拐	hji	hji
贤	prq	prq
崽	ebn	ebn
皱	qoz	qoz
削	dvp	dvp
婊	gqy	gqy
秘	wna	wna
阅	evk	evk
承	wio	wio
骆	rog	rog
搁	heo	heo
祭	tls	tls
劫	aoi	aoi
罩	chu	chu
筋	kvi	kvi
厅	wrd	wrd
闭	eua	eua
肖	dvy	dvy
辉	dlp	dlp
洲	odg	odg
危	qwc	qwc
拎	hrl	hrl
妻	xgn	xgn
掏	hfb	hfb
汇	oak	oak
雕	gqr	gqr
眉	nfm	nfm
吕	jjk	jjk
惟	nru	nru
赴	dhb	dhb
阵	fpc	fpc
珈	vij	vij
尤	dyy	dyy
夺	kuc	kuc
巾	zjj	zjj
忽	fin	fin
鹅	hqz	hqz
涅	oml	oml
泼	ojr	ojr
警	bsi	bsi
凸	vei	vei
傲	mql	mql
耗	tse	tse
桃	skf	skf
盲	pfm	pfm
楚	chf	chf
玲	vrl	vrl
塌	adn	adn
注	ozv	ozv
渐	opl	opl
灌	obr	obr
岭	erl	erl
俞	gvp	gvp
返	wro	wro
琼	vch	vch
脉	vzi	vzi
堡	mja	mja
择	hrh	hrh
携	hrv	hrv
佬	maw	maw
恒	neb	neb
册	ycc	ycc
郝	anf	anf
膘	vul	vul
艳	qqo	qqo
企	kji	kji
席	xuz	xuz
慈	syn	syn
阔	eof	eof
触	qcc	qcc
啾	jwx	jwx
锋	tlq	tlq
哲	hlj	hlj
壶	fny	fny
岗	egh	egh
司	wme	wme
训	igc	igc
模	slm	slm
讯	iwu	iwu
兜	nyk	nyk
宾	llt	llt
陶	ffb	ffb
寿	quc	quc
唷	jtv	jtv
喘	jeh	jeh
霸	rzv	rzv
痴	uvj	uvj
噻	jla	jla
鸣	jzn	jzn
尹	oap	oap
兮	tek	tek
遛	ybo	ybo
劳	yil	yil
梳	stg	stg
仕	mas	mas
逸	zko	zko
徒	kdo	kdo
箭	ksp	ksp
铅	tbj	tbj
束	pss	pss
误	ijm	ijm
脖	vfu	vfu
币	azj	azj
刊	kpd	kpd
欺	onq	onq
庭	xvo	xvo
妥	agn	agn
鸿	oez	oez
揪	hwx	hwx
仿	myf	myf
续	yuk	yuk
怡	noj	noj
予	cvv	cvv
仑	kwb	kwb
尝	dty	dty
锤	txt	txt
激	onl	onl
炎	xxh	xxh
翼	nbt	nbt
序	xcv	xcv
宣	leb	leb
怨	xcn	xcn
态	kzn	kzn
疤	uob	uob
滨	olt	olt
弦	ipy	ipy
迈	epo	epo
鹰	xmz	xmz
唠	jyi	jyi
婆	ozg	ozg
澳	osk	osk
菌	bgw	bgw
卯	ymm	ymm
茜	bux	bux
雯	rcw	rcw
拦	hso	hso
眠	fbm	fbm
券	mpd	mpd
乜	wwe	wwe
债	mne	mne
亭	crd	crd
窄	rra	rra
饶	wql	wql
宴	ldg	ldg
框	sav	sav
棍	sdx	sdx
丰	qff	qff
契	qpk	qpk
勃	fui	fui
覆	ukl	ukl
患	rrn	rrn
脆	vqc	vqc
邱	lef	lef
铲	tkw	tkw
叉	rzd	rzd
俏	mdv	mdv
悟	nvj	nvj
脂	vwd	vwd
喻	jgp	jgp
御	kbc	kbc
倩	mqv	mqv
枚	slx	slx
险	fgd	fgd
尘	hat	hat
裹	ybs	ybs
牢	lfn	lfn
粒	dkl	dkl
探	hcs	hcs
蜂	clq	clq
技	hur	hur
寂	lir	lir
韦	hww	hww
婷	gcr	gcr
幻	ywe	ywe
岩	eus	eus
贫	tpq	tpq
延	ajo	ajo
奏	qmt	qmt
柏	snb	snb
疑	wvh	wvh
蒜	bll	bll
哀	yjk	yjk
审	lds	lds
幕	lzj	lzj
妃	gaj	gaj
姿	fng	fng
亡	pww	pww
蘸	bzx	bzx
翠	npu	npu
鼎	fyy	fyy
尺	nzd	nzd
诸	iae	iae
唰	jnp	jnp
抵	hyz	hyz
煲	mjx	mjx
振	hzc	hzc
置	cni	cni
葛	bdp	bdp
腔	vre	vre
馅	wqy	wqy
浇	oql	oql
恐	ebn	ebn
呛	jkc	jkc
忆	nwi	nwi
憨	wfn	wfn
愈	gvn	gvn
藤	bvi	bvi
虹	ceg	ceg
售	rjk	rjk
坛	aty	aty
逮	xio	xio
瞪	fta	fta
葬	bxb	bxb
棉	snz	snz
隐	fqn	fqn
缓	yar	yar
铜	tgm	tgm
踏	eid	eid
避	njo	njo
孕	vui	vui
拙	hjg	hjg
彼	kzp	kzp
屯	ejc	ejc
筒	kgm	kgm
斩	plj	plj
息	dnx	dnx
递	sqo	sqo
巷	uto	uto
誉	dti	dti
戈	qgg	qgg
营	yjj	yjj
讨	iuc	iuc
绒	yqu	yqu
融	ucc	ucc
喃	jui	jui
昏	yvd	yvd
势	hm	hm
浴	ocg	ocg
跃	emt	emt
潜	omd	omd
纽	ywa	ywa
惜	nud	nud
仗	meh	meh
磅	uky	uky
访	iyf	iyf
闺	evg	evg
媛	gar	gar
漆	osi	osi
沫	opm	opm
韵	sff	sff
陵	fal	fal
奉	qhs	qhs
谍	ius	ius
仪	mzh	mzh
垮	ake	ake
绘	ykt	ykt
瑜	vgp	vgp
适	fod	fod
协	uit	uit
迁	xod	xod
启	zjk	zjk
姬	gec	gec
培	akj	akj
乙	wii	wii
枣	nfb	nfb
篮	kpc	kpc
监	pkc	pkc
央	gkd	gkd
揭	hdp	hdp
垂	xbt	xbt
冤	czz	czz
绮	ykx	ykx
葵	btm	btm
煞	qox	qox
栏	sso	sso
傅	mtu	mtu
涛	oqu	oqu
议	izh	izh
恕	gjn	gjn
霞	rnr	rnr
蛙	cvg	cvg
谋	iys	iys
伏	mpq	mpq
销	tdv	tdv
恰	ngh	ngh
盾	wuf	wuf
龄	arl	arl
奈	kls	kls
焖	xen	xen
壹	fad	fad
瞒	fbk	fbk
袜	lpm	lpm
伸	mds	mds
坊	ayf	ayf
妇	gow	gow
邀	nyo	nyo
裁	uqy	uqy
幼	yil	yil
睁	fqx	fqx
翁	ton	ton
羽	nvv	nvv
亨	ctl	ctl
萱	blb	blb
瓷	fnm	fnm
墓	lat	lat
妍	gck	gck
映	dgk	dgk
幽	eyy	eyy
晾	dch	dch
奴	gry	gry
娅	gen	gen
拣	hvh	hvh
屈	njg	njg
玄	pyy	pyy
吨	jej	jej
茬	bua	bua
兆	kff	kff
棕	sll	sll
倾	mwt	mwt
燥	xjs	xjs
辈	ppc	ppc
掺	hoi	hoi
栽	uqs	uqs
磊	uuu	uuu
账	qic	qic
历	wil	wil
暮	ldr	ldr
芽	bay	bay
钉	trd	trd
估	mxg	mxg
飙	pph	pph
鞭	zmp	zmp
帆	zbz	zbz
押	hgj	hgj
涮	onp	onp
玻	vzp	vzp
捷	hxh	hxh
笼	kzl	kzl
链	tpo	tpo
豹	pfz	pfz
噎	jfa	jfa
委	wgn	wgn
淋	ocl	ocl
府	xmu	xmu
哔	jxu	jxu
庸	xxe	xxe
楞	scy	scy
岳	lee	lee
媒	gys	gys
纲	ygh	ygh
黛	mqs	mqs
番	ibt	ibt
杏	sjk	sjk
毅	krt	krt
纵	ykk	ykk
摁	hgn	hgn
禾	whh	whh
绛	yla	yla
撮	hdr	hdr
享	cui	cui
袭	zyi	zyi
逝	hlo	hlo
突	rpq	rpq
泌	ona	ona
柱	szv	szv
击	hgk	hgk
秃	wbj	wbj
律	kxv	kxv
浦	otf	otf
责	nee	nee
叽	jbj	jbj
岸	ewk	ewk
绣	ywv	ywv
馨	and	and
哑	jen	jen
涌	ooe	ooe
炜	xhw	xhw
务	lil	lil
旭	mdr	mdr
荒	bpg	bpg
暂	pld	pld
懵	nbf	nbf
龚	zut	zut
坚	pra	pra
欸	ovn	ovn
妄	pgn	pgn
窜	rrr	rrr
锐	tvk	tvk
霄	rdv	rdv
琦	vkx	vkx
察	ltl	ltl
茨	bfn	bfn
悔	ntn	ntn
捶	hxt	hxt
允	oke	oke
哨	jdv	jdv
济	ocn	ocn
资	fnq	fnq
斌	cej	cej
奸	gkg	gkg
芦	bzh	bzh
厉	wep	wep
俱	mkt	mkt
宥	luv	luv
薪	bkl	bkl
郁	uvf	uvf
藕	btr	btr
雀	hru	hru
桂	svg	svg
苍	bkc	bkc
畅	dwi	dwi
仰	myc	myc
兑	vke	vke
竞	kjk	kjk
丘	lei	lei
措	hud	hud
瘫	urr	urr
逐	rod	rod
灿	xes	xes
荡	qwi	qwi
廷	voy	voy
邵	mfe	mfe
齿	acc	acc
咽	jgk	jgk
廊	xzf	xzf
酿	zzm	zzm
钩	tfo	tfo
弓	igg	igg
垦	mat	mat
臂	njv	njv
浆	yxi	yxi
涩	opj	opj
捕	htf	htf
楠	sui	sui
汀	ord	ord
伍	mvu	mvu
姨	gki	gki
癖	unf	unf
誓	hli	hli
囤	gej	gej
瘾	ufn	ufn
搏	htu	htu
挽	hzk	hzk
颖	wwt	wwt
呲	jjw	jjw
疾	uvs	uvs
撩	hkh	hkh
枉	svw	svw
嗑	jac	jac
悠	mln	mln
蛆	ckq	ckq
渝	ogp	ogp
璐	veo	veo
祥	liy	liy
浑	ocp	ocp
匀	ffb	ffb
符	kmu	kmu
脾	vgu	vgu
焚	cxh	cxh
呈	jvw	jvw
宪	lfk	lfk
昆	dxb	dxb
椅	skx	skx
铊	tlw	tlw
阁	eog	eog
涵	owg	owg
滩	orr	orr
艰	rmg	rmg
芭	bob	bob
囊	fdy	fdy
蹬	eta	eta
隅	fbr	fbr
刨	fop	fop
萝	bcx	bcx
壁	nja	nja
吟	jrw	jrw
繁	tny	tny
腚	vlh	vlh
丙	ern	ern
碳	uex	uex
钙	tew	tew
坦	abd	abd
茧	bcc	bcc
典	ytb	ytb
彪	xbi	xbi
泄	ouw	ouw
揽	hpe	hpe
棵	sbs	sbs
骏	rol	rol
貌	pnk	pnk
佟	mlf	mlf
嘚	jku	jku
娟	gjv	gjv
掩	hku	hku
卒	pku	pku
巫	ekk	ekk
卵	yll	yll
徽	kys	kys
哗	jmu	jmu
挪	hwf	hwf
育	tvy	tvy
佐	mue	mue
祛	lao	lao
颈	ret	ret
佑	muy	muy
枯	sxg	sxg
辰	zcc	zcc
夕	xxx	xxx
效	fhl	fhl
糙	dfo	dfo
葡	bft	bft
栋	svh	svh
益	stc	stc
敦	cul	cul
辱	zuc	zuc
午	tus	tus
验	rgd	rgd
卿	ymg	ymg
眯	fdm	fdm
策	knb	knb
丧	asy	asy
津	oxv	oxv
陌	fub	fub
靖	kqv	kqv
痰	uxx	uxx
苑	bxc	bxc
孽	bau	bau
笋	koa	koa
昭	dma	dma
挥	hcp	hcp
灶	xat	xat
帘	rzj	rzj
诛	iap	iap
珍	vki	vki
舰	lej	lej
圭	vgg	vgg
嫖	gul	gul
铃	trl	trl
驱	rah	rah
贯	nqb	nqb
释	irh	irh
聪	fvn	fvn
滕	vmi	vmi
谎	ibg	ibg
瓣	faf	faf
预	cty	cty
扰	hdy	hdy
泛	oab	oab
矿	uxg	uxg
掖	hpl	hpl
谭	iuu	iuu
椒	sir	sir
例	mxp	mxp
傍	mky	mky
厨	wau	wau
屹	etw	etw
铭	txj	txj
谜	ido	ido
吱	jur	jur
晶	ddd	ddd
颂	tot	tot
纬	yhw	yhw
鹤	crz	crz
萍	qks	qks
纱	yha	yha
匠	alj	alj
潭	ouu	ouu
综	yll	yll
铝	tjj	tjj
斋	che	che
涉	ojh	ojh
廖	xni	xni
蔻	blx	blx
镐	tcg	tcg
狐	pag	pag
谓	ibv	ibv
嗅	jdp	jdp
炭	eux	eux
莹	ylv	ylv
频	jht	jht
婶	gld	gld
献	ugp	ugp
喉	jmv	jmv
屠	nae	nae
匹	ake	ake
妾	kgn	kgn
梵	cbz	cbz
遗	cqo	cqo
愚	brn	brn
烈	xpx	xpx
晋	end	end
淹	oku	oku
桩	sxa	sxa
俾	mgu	mgu
嚓	jll	jll
撅	hwn	hwn
昊	dmt	dmt
牧	flx	flx
殿	nut	nut
甭	jey	jey
癌	uje	uje
蜡	cud	cud
泳	ozi	ozi
灾	lxh	lxh
禄	loi	loi
痕	umg	umg
喆	qqj	qqj
绍	yma	yma
详	iiy	iiy
贞	hqb	hqb
畔	bsh	bsh
卦	vhb	vhb
溢	osc	osc
蚝	cem	cem
寨	lws	lws
啤	jgu	jgu
拓	hus	hus
霉	rtn	rtn
厝	wud	wud
咕	jxg	jxg
崴	eig	eig
棚	svv	svv
厌	wpq	wpq
貂	pma	pma
镁	tik	tik
倪	myk	myk
寡	ltp	ltp
翅	urn	urn
隽	rvn	rvn
嘭	jpi	jpi
梓	sfx	sfx
荤	ypc	ypc
崖	ewv	ewv
杭	spb	spb
寝	lyr	lyr
渴	odp	odp
辨	fpf	fpf
妓	gur	gur
殇	xti	xti
舱	lkc	lkc
材	sua	sua
恃	nws	nws
榛	sqw	sqw
阻	fkq	fkq
袖	lgy	lgy
究	rmj	rmj
烙	xog	xog
嚷	jyw	jyw
矛	cmm	cmm
恼	npg	npg
掀	hln	hln
耀	dlr	dlr
撇	hwl	hwl
嚎	jcr	jcr
怜	nrl	nrl
炉	xzh	xzh
栅	syc	syc
硅	uvg	uvg
彦	kwi	kwi
刹	hsp	hsp
戚	iih	iih
驼	rlw	rlw
蒽	bgn	bgn
坪	aks	aks
泷	ozl	ozl
肤	vmf	vmf
嗡	jtn	jtn
巢	gbs	gbs
授	hir	hir
皿	cmm	cmm
晏	dlg	dlg
轶	pam	pam
瑶	vab	vab
裆	ldo	ldo
蹄	ekz	ekz
嘟	jaf	jaf
径	kre	kre
渔	ozv	ozv
熄	xdn	xdn
籍	ktd	ktd
灸	qzx	qzx
禽	kpr	kpr
窦	ruk	ruk
扩	hxg	hxg
乍	raa	raa
婵	gvu	gvu
穴	rxx	rxx
耻	fji	fji
谣	iab	iab
镶	tyw	tyw
俯	mxu	mxu
陀	flw	flw
蜀	cfc	cfc
钦	tnq	tnq
凝	fwh	fwh
倚	mkx	mkx
裕	lcg	lcg
卜	hbb	hbb
缸	beg	beg
沿	obj	obj
拥	hey	hey
捣	hze	hze
阉	eku	eku
储	mia	mia
蓉	blc	blc
噔	jta	jta
匿	abu	abu
确	uqj	uqj
芝	bbi	bbi
吒	jav	jav
莓	btn	btn
躁	ejs	ejs
僵	mee	mee
呕	jah	jah
垵	alg	alg
彤	gpi	gpi
捎	hdv	hdv
蛤	cgh	cgh
畏	bey	bey
叙	kwr	kwr
毙	xxw	xxw
氧	tiy	tiy
焉	bex	bex
獒	qpp	qpp
彻	kvp	kvp
浙	ohl	ohl
盟	dvc	dvc
腥	vdn	vdn
蔚	bnu	bnu
叮	jrd	jrd
拟	hwk	hwk
迅	wuo	wuo
嗔	jnt	jnt
靡	xcp	xcp
橘	scj	scj
统	ytk	ytk
迹	qod	qod
雇	zru	zru
乏	abi	abi
宵	ldv	ldv
碑	ugu	ugu
胀	vic	vic
锥	tru	tru
疗	utl	utl
担	hbd	hbd
遥	abo	abo
盏	eqc	eqc
聂	frs	frs
污	oee	oee
援	har	har
芊	bxq	bxq
茄	bij	bij
扳	hwr	hwr
觅	aej	aej
励	wei	wei
昨	dra	dra
嗝	jug	jug
瘪	udw	udw
丛	kke	kke
稠	wgq	wgq
郅	gfe	gfe
轨	pmj	pmj
醇	zcu	zcu
奕	qkd	qkd
燃	xvx	xvx
锡	tdi	tdi
崇	ell	ell
溅	oqq	oqq
芮	brn	brn
煤	xys	xys
啸	jxt	jxt
瘤	uyb	uyb
笈	krj	krj
撬	hee	hee
茂	biu	biu
钵	tse	tse
珀	vnb	vnb
畜	pyb	pyb
硫	utg	utg
坠	fka	fka
泊	onb	onb
隋	fuv	fuv
瞟	ful	ful
杉	sis	sis
枫	sbh	sbh
榨	srr	srr
邹	qof	qof
腌	vku	vku
泯	obm	obm
揣	heh	heh
氪	txk	txk
儒	mrh	mrh
奢	kae	kae
棱	sal	sal
渗	ooi	ooi
焕	xqk	xqk
阎	eqy	eqy
艘	lyr	lyr
辽	tod	tod
违	hod	hod
磁	usy	usy
溶	olc	olc
绞	yfh	yfh
浸	oor	oor
潇	obt	obt
舅	ybi	ybi
媚	gnf	gnf
诉	ilz	ilz
骄	rmn	rmn
茱	bap	bap
弥	iqh	iqh
滋	osy	osy
瞭	fkh	fkh
膝	vsi	vsi
茵	bgk	bgk
蓬	blo	blo
巡	god	god
汝	ogn	ogn
窥	rme	rme
肛	veg	veg
阶	fkn	fkn
淌	odj	odj
渤	ofi	ofi
蚊	ccw	ccw
蝉	cvu	cvu
逊	uho	uho
愤	nuq	nuq
荼	bkw	bkw
骁	rql	rql
栓	skv	skv
犊	fuk	fuk
猎	pud	pud
嘀	jkx	jkx
笛	kgy	kgy
辑	pjf	pjf
聘	fge	fge
苔	boj	boj
疏	htg	htg
腊	vud	vud
寇	ltx	ltx
攀	chh	chh
曦	diq	diq
踪	ell	ell
虑	xnx	xnx
贷	mqq	mqq
鲸	zch	zch
喳	jsb	jsb
域	aqm	aqm
缴	ynl	ynl
螺	cby	cby
滇	ont	ont
叭	jtb	jtb
晖	dcp	dcp
固	gxg	gxg
檀	spb	spb
睿	xtf	xtf
谤	iky	iky
赋	qej	qej
窃	rvp	rvp
闫	eos	eos
蓄	bpb	bpb
淇	ooq	ooq
朋	vvy	vvy
瑾	vzt	vzt
坞	azu	azu
雁	wmr	wmr
咻	jms	jms
恭	uth	uth
拷	hae	hae
碍	ubu	ubu
召	maa	maa
豁	lqc	lqc
颁	tpt	tpt
魄	ngo	ngo
桓	seb	seb
澜	oes	oes
椰	sff	sff
瘟	udc	udc
盈	vrc	vrc
徕	kps	kps
滥	opc	opc
弧	iag	iag
惶	nnv	nnv
禹	ajr	ajr
魅	gop	gop
嗳	jir	jir
筛	kpz	kpz
倦	mmc	mmc
旋	yth	yth
检	sgd	sgd
氢	tre	tre
芒	bpw	bpw
跶	eko	eko
遂	sro	sro
钞	tha	tha
倔	mng	mng
脓	vcy	vcy
陟	fjh	fjh
樊	chk	chk
刁	wei	wei
萎	bwg	bwg
逾	gvo	gvo
炼	xvh	xvh
莪	bhq	bhq
吆	jyy	jyy
咏	jzi	jzi
茹	bgj	bgj
蔫	bbx	bbx
悍	ndk	ndk
槟	slt	slt
缕	ydg	ydg
塑	sja	sja
舵	llw	llw
锣	tcx	tcx
喏	jbu	jbu
恁	mvn	mvn
痞	ujj	ujj
麟	ada	ada
溯	osv	osv
趋	dqo	dqo
拴	hkv	hkv
遁	wuo	wuo
旱	dkg	dkg
鸽	gzn	gzn
娄	dgn	dgn
娱	gjm	gjm
寅	leg	leg
抚	hcu	hcu
植	sni	sni
榕	slc	slc
嗓	jrs	jrs
恢	nux	nux
饰	wtz	wtz
楷	sxn	sxn
滤	oxn	oxn
腮	vbn	vbn
漾	oii	oii
粤	sde	sde
铛	tdo	tdo
腺	vni	vni
筐	kav	kav
叨	jpd	jpd
弩	gri	gri
慰	nln	nln
莺	yzn	yzn
娴	ges	ges
蛊	ccm	ccm
遵	zuo	zuo
搽	hbs	hbs
乒	lea	lea
奎	kvg	kvg
瑛	vbk	vbk
牲	fns	fns
荫	bfv	bfv
辫	fyf	fyf
鉴	pkt	pkt
雌	jwr	jwr
颓	wbt	wbt
忻	nlj	nlj
梯	ssq	ssq
矗	nnn	nnn
矫	vmn	vmn
焗	xnj	xnj
抡	hkw	hkw
珂	vxk	vxk
督	ihf	ihf
矬	vka	vka
伶	mrl	mrl
婉	glc	glc
昧	dpw	dpw
绊	ysh	ysh
询	ifd	ifd
厮	wol	wol
肃	xnt	xnt
趾	eji	eji
述	szo	szo
邢	cfe	cfe
酮	zgm	zgm
辅	ptf	ptf
螨	cbk	cbk
裱	lqy	lqy
怖	nuz	nuz
捆	hgs	hgs
廉	xsn	xsn
皓	nfj	nfj
眨	fab	fab
衬	luc	luc
纶	ykw	ykw
镑	tky	tky
呱	jag	jag
斥	lzd	lzd
歉	son	son
蒲	qtf	qtf
诱	iwv	iwv
贡	eqb	eqb
咚	jlf	jlf
嫦	gdz	gdz
柚	sgy	sgy
窑	rbf	rbf
毫	cem	cem
耙	tso	tso
蕉	brx	brx
示	lss	lss
耕	tsw	tsw
吭	jpb	jpb
渺	ofa	ofa
辕	pay	pay
阜	adu	adu
匪	apf	apf
暑	dae	dae
玫	vlx	vlx
筑	kez	kez
喀	jlo	jlo
炕	xpb	xpb
霖	rcl	rcl
泣	okl	okl
烘	xut	xut
芋	beu	beu
剖	kjp	kjp
唤	jqk	jqk
桔	sqj	sqj
町	brd	brd
筹	kqu	kqu
绵	ynz	ynz
荆	bcp	bcp
渊	ond	ond
咿	jma	jma
岑	erw	erw
株	sap	sap
淳	ocu	ocu
耸	kkf	kkf
驰	rdy	rdy
苯	bse	bse
辟	njf	njf
恬	nfs	nfs
迫	nod	nod
勋	jqi	jqi
奋	kbt	kbt
叁	oko	oko
嘣	jev	jev
墩	acl	acl
栖	sux	sux
竿	kkg	kkg
贸	yqb	yqb
阮	ftk	ftk
偿	mdt	mdt
庞	xzl	xzl
泻	oce	oce
袄	lmt	lmt
冈	ghi	ghi
篱	kpr	kpr
绷	yvv	yvv
堤	adh	adh
癣	uzi	uzi
贬	qab	qab
凳	tab	tab
闵	ecw	ecw
璇	vyh	vyh
榆	sgp	sgp
吡	jxb	jxb
崎	ekx	ekx
煨	xby	xby
霎	rkg	rkg
拂	hin	hin
淑	oir	oir
伙	mxh	mxh
婴	qqg	qqg
缇	ydh	ydh
跋	eur	eur
糯	drh	drh
促	meu	meu
昕	dlj	dlj
毯	exx	exx
痨	uyi	uyi
杵	stu	stu
吽	jfn	jfn
羡	ifn	ifn
蛹	coe	coe
弘	ios	ios
岚	ebh	ebh
暇	dnr	dnr
瘸	uik	uik
艇	lvo	lvo
钰	tlv	tlv
嚣	dtd	dtd
嵩	ecg	ecg
秉	wow	wow
厕	wqp	wqp
嗤	jjc	jjc
娼	gdd	gdd
巳	oss	oss
嬴	pjg	pjg
瀚	oun	oun
茅	bcm	bcm
览	pke	pke
遣	cdo	cdo
弊	wlb	wlb
膨	vpi	vpi
碘	uyt	uyt
馊	wyr	wyr
侵	mor	mor
庇	xxb	xxb
缪	yni	yni
褪	lmo	lmo
砰	uks	uks
馍	wlm	wlm
垢	awm	awm
孰	cuz	cuz
暄	dlb	dlb
障	fsu	fsu
歼	xxq	xxq
狸	pml	pml
眈	fck	fck
岔	tpe	tpe
邻	rfe	rfe
雍	pyr	pyr
砌	uvp	uvp
擤	hdl	hdl
胯	vke	vke
嗖	jyr	jyr
郜	fjf	fjf
馥	wdl	wdl
罕	ctk	ctk
冉	gat	gat
嗜	jad	jad
囚	gkr	gkr
屡	ndg	ndg
庚	xok	xok
栗	usm	usm
疆	iae	iae
诊	iki	iki
恺	nea	nea
捋	hau	hau
摞	hby	hby
旦	bdd	bdd
铮	tqx	tqx
碾	uny	uny
缁	ygb	ygb
蕃	bib	bib
贰	qtq	qtq
俐	mwp	mwp
酉	zyy	zyy
饺	wfh	wfh
袅	zyi	zyi
汽	otq	otq
浊	occ	occ
茎	bre	bre
掂	hxl	hxl
耽	fck	fck
佰	mub	mub
堕	fua	fua
杖	seh	seh
癫	unt	unt
勉	zki	zki
皎	nfh	nfh
矢	vss	vss
怯	nao	nao
掷	hsf	hsf
坂	awr	awr
蟒	cbb	cbb
乾	udw	udw
狄	pxh	pxh
眷	mfm	mfm
稻	way	way
肘	vuc	vuc
唬	jxb	jxb
诈	ira	ira
钧	tff	tff
劣	hai	hai
函	wig	wig
撂	hbo	hbo
盹	fej	fej
蕊	bnn	bnn
坝	aqb	aqb
朦	vyr	vyr
瘀	uyf	uyf
幺	yyy	yyy
沁	onx	onx
纤	yxq	yxq
啷	jzf	jzf
擒	hkr	hkr
啼	jkz	jkz
殷	wot	wot
刃	pzd	pzd
羹	ixk	ixk
颐	ety	ety
柿	spz	spz
烨	xmu	xmu
礁	urx	urx
穗	wtn	wtn
郡	oaf	oaf
沐	osm	osm
翰	udn	udn
卑	gus	gus
癸	tmt	tmt
箍	khz	khz
郊	fhf	fhf
闰	evw	evw
噌	jvd	jvd
贩	qwr	qwr
啄	jrz	jrz
鳄	zde	zde
庐	xzh	xzh
芸	bty	bty
苹	bks	bks
虏	xil	xil
魁	gol	gol
聋	zfe	zfe
鳖	wlz	wlz
齁	dbs	dbs
鲨	ohz	ohz
冶	foj	foj
拘	hsj	hsj
炝	xkc	xkc
纠	ycj	ycj
锯	tnx	tnx
寰	lcy	lcy
彬	cis	cis
恳	mnx	mnx
柄	ser	ser
讹	imw	imw
叛	shr	shr
沽	oxg	oxg
笃	krm	krm
糜	xcd	xcd
俭	mgd	mgd
匡	avw	avw
憾	nin	nin
概	smc	smc
荐	buu	buu
铰	tfh	tfh
哏	jmg	jmg
濯	onr	onr
疲	uzp	uzp
鄂	def	def
署	cae	cae
偈	mdp	mdp
痔	uws	uws
瞬	fia	fia
呷	jgj	jgj
垒	ooa	ooa
描	hbb	hbb
拇	hnm	hnm
桐	sgm	sgm
浣	olk	olk
溃	ocq	ocq
酌	zfz	zfz
囡	ggn	ggn
沼	oma	oma
薜	bnf	bnf
鸠	mzn	mzn
戾	zpq	zpq
蜗	cjr	cjr
裴	pyi	pyi
亩	pbt	pbt
噪	jjs	jjs
埸	adi	adi
袍	lfo	lfo
咂	jaz	jaz
姣	gfh	gfh
翟	nru	nru
惧	nkt	nkt
炯	xgj	xgj
狱	pip	pip
笙	kns	kns
陋	fnp	fnp
涯	owv	owv
渍	one	one
簋	kmc	kmc
谛	ikz	ikz
伽	mij	mij
闸	egj	egj
孜	ulx	ulx
馁	wag	wag
啖	jxx	jxx
墅	mca	mca
拈	hla	hla
掘	hng	hng
澍	opu	opu
腕	vlc	vlc
酬	zdg	zdg
屑	ndv	ndv
戊	iuu	iuu
滞	oyz	oyz
嘈	jyd	jyd
垣	aeb	aeb
析	slj	slj
虱	wac	wac
濑	opq	opq
睬	fic	fic
钮	twa	twa
鸥	ahz	ahz
鼬	ygy	ygy
禀	pdl	pdl
菡	bwg	bwg
讷	irn	irn
雏	qor	qor
履	nkl	nkl
蚺	cga	cga
巅	ent	ent
歆	snq	snq
烛	xcc	xcc
匝	azj	azj
澈	otl	otl
灏	oxt	oxt
烹	ctx	ctx
犟	ijf	ijf
磡	uoi	uoi
陕	fms	fms
姝	gap	gap
痧	uoa	uoa
芹	blj	blj
谗	izf	izf
鞍	zlg	zlg
涠	ogh	ogh
炳	xer	xer
羲	iwq	iwq
铬	tog	tog
吠	jpq	jpq
夭	mtt	mtt
寐	lyp	lyp
昔	udr	udr
菱	bal	bal
藩	qib	qib
饥	wbj	wbj
仆	mhb	mhb
坯	aje	aje
悉	inx	inx
拄	hzv	hzv
薯	bca	bca
锺	txm	txm
侨	mmn	mmn
悌	nsq	nsq
韧	hpz	hpz
梢	sdv	sdv
哺	jtf	jtf
氨	tlg	tlg
顽	tkt	tkt
亥	phh	phh
壬	vww	vww
戌	iei	iei
殴	aht	aht
簿	kou	kou
棣	sxi	sxi
爵	acu	acu
脐	vcn	vcn
苇	bhw	bhw
钳	tyg	tyg
鸦	azn	azn
俚	mml	mml
瓢	ula	ula
秆	wkg	wkg
诵	ioe	ioe
轿	pmn	pmn
叩	jcj	jcj
摧	her	her
洙	oap	oap
胤	kyv	kyv
脊	ffv	ffv
萼	bde	bde
虞	xjm	xjm
澄	ota	ota
萄	bfb	bfb
衍	pos	pos
挞	hko	hko
蔓	bqm	bqm
斧	thl	thl
祇	lyv	lyv
稚	wru	wru
粟	udm	udm
絮	gjy	gjy
霆	rvo	rvo
尻	nmj	nmj
疮	ukc	ukc
吮	jok	jok
孑	tei	tei
甸	fbt	fbt
膈	vug	vug
夷	kig	kig
幢	zkm	zkm
旨	wdr	wdr
碇	ulh	ulh
溏	oxj	oxj
颊	mst	mst
驹	rsj	rsj
嘬	jdr	jdr
循	kwf	kwf
浒	oiu	oiu
硌	uog	uog
蚁	czh	czh
馕	wfy	wfy
榴	syb	syb
檐	sqi	sqi
缅	ytm	ytm
唆	jol	jol
孬	jgu	jgu
琛	vcs	vcs
疹	uki	uki
碜	uoi	uoi
芥	bkn	bkn
驳	rhh	rhh
踮	exl	exl
钝	tej	tej
钛	tkz	tkz
鹭	eoz	eoz
屿	eee	eee
拢	hzl	hzl
撵	hmp	hmp
擀	huk	huk
燮	ixr	ixr
筝	kqx	kqx
靶	zob	zob
饬	wti	wti
侍	mws	mws
厦	wtl	wtl
溺	oif	oif
烩	xkt	xkt
逑	iod	iod
厘	wml	wml
涕	osq	osq
熨	nlx	nlx
磐	ltu	ltu
旷	dxg	dxg
梆	sqf	sqf
谐	ixn	ixn
攥	hky	hky
歧	jur	jur
苞	bfo	bfo
捻	hrn	hrn
疣	udy	udy
苓	brl	brl
枭	zsm	zsm
梭	sol	sol
濮	omz	omz
瞳	fkm	fkm
谴	ico	ico
豫	czx	czx
乞	twi	twi
皖	nlk	nlk
糠	dxi	dxi
釉	igy	igy
况	fjk	fjk
庵	xku	xku
睛	fqv	fqv
窘	roj	roj
喧	jlb	jlb
棠	djs	djs
粿	dbs	dbs
衡	pzk	pzk
硝	udv	udv
蚀	wcc	wcc
嵌	eyn	eyn
泾	ore	ore
渠	oas	oas
漱	opn	opn
琉	vtg	vtg
祈	llj	llj
肋	vil	vil
钠	trn	trn
鬟	icy	icy
啫	jae	jae
碉	ugq	ugq
捯	hgp	hgp
枢	sah	sah
樽	szu	szu
绫	yal	yal
茗	bxj	bxj
藉	btd	btd
谊	ilk	ilk
晤	dvj	dvj
驿	rrh	rrh
勘	owi	owi
卟	jhb	jhb
睹	fae	fae
肽	vkz	vkz
芃	bbz	bbz
菅	bld	bld
诡	iqc	iqc
嗬	jbx	jbx
垛	abs	abs
娥	ghq	ghq
庹	xuz	xuz
涧	oed	oed
苟	bsj	bsj
驶	rjh	rjh
伢	may	may
匙	dhw	dhw
啐	jpu	jpu
嘶	jol	jol
笠	kkl	kkl
谂	irn	irn
圃	gtf	gtf
襟	lcl	lcl
泵	uis	uis
洇	ogk	ogk
赃	qxa	qxa
陡	fdo	fdo
咣	jdl	jdl
抻	hds	hds
汞	eis	eis
碱	uim	uim
绥	yag	yag
舜	ixa	ixa
萦	yys	yys
颌	gty	gty
堇	zte	zte
粼	dxg	dxg
缀	yrr	yrr
诫	iqb	iqb
锌	tfx	tfx
冀	ywt	ywt
擎	bsh	bsh
橱	swu	swu
倏	mlp	mlp
剽	ulp	ulp
巩	ebz	ebz
氟	tin	tin
滢	oyl	oyl
琅	vzm	vzm
禧	lpj	lpj
丈	ehi	ehi
哧	jan	jan
嫣	gbx	gbx
胥	hvy	hvy
沧	okc	okc
孵	yau	yau
濠	ocr	ocr
诃	ixk	ixk
韬	hay	hay
彰	sui	sui
惑	qmn	qmn
歹	xdd	xdd
耿	fxh	fxh
凿	nig	nig
廋	xyr	xyr
沸	oin	oin
瀑	odi	odi
煸	xzy	xzy
脯	vtf	vtf
裔	ygj	ygj
媳	gdn	gdn
暨	mcb	mcb
棺	sld	sld
煽	xzn	xzn
罔	gsp	gsp
跷	eql	eql
黍	wki	wki
卅	bcc	bcc
椎	sru	sru
胗	vki	vki
蚕	mcc	mcc
蛛	cap	cap
螈	cwh	cwh
汾	otp	otp
沥	owi	owi
窖	rfj	rfj
徨	knv	knv
湉	onf	onf
牟	ofn	ofn
疫	uts	uts
坍	agp	agp
甫	tff	tff
缰	yee	yee
铸	tqu	tqu
敛	gdl	gdl
沂	olj	olj
粱	opd	opd
酶	ztn	ztn
岫	egy	egy
杳	sdr	sdr
泠	orl	orl
荔	bii	bii
藓	bzi	bzi
锈	twv	twv
氓	pbm	pbm
璧	njl	njl
骤	rfi	rfi
鳞	zda	zda
壕	acr	acr
搀	hzf	hzf
氮	txx	txx
窟	rng	rng
箕	koq	koq
舀	ayj	ayj
括	hfs	hfs
炙	vxh	vxh
砣	ulw	ulw
纺	yyf	yyf
绩	yne	yne
酣	zyg	zyg
鳓	zzi	zzi
哐	jav	jav
唧	jmc	jmc
址	aji	aji
屙	nfx	nfx
役	kts	kts
晗	drj	drj
楹	svc	svc
衩	lrz	lrz
褒	yms	yms
锉	tka	tka
鼯	yvj	yvj
嗣	jym	jym
嚄	jbr	jbr
擅	hpb	hpb
淼	iii	iii
璞	vnz	vnz
盅	rcm	rcm
褚	lae	lae
躯	gah	gah
掴	hgl	hgl
炅	dxh	dxh
秧	wgk	wgk
簪	kcd	kcd
胧	vzl	vzl
胰	vki	vki
艋	luc	luc
菖	bdd	bdd
蕴	byc	byc
樟	ssu	ssu
磷	uda	uda
肢	vur	vur
艮	mgg	mgg
咛	jlr	jlr
睽	ftm	ftm
祺	loq	loq
镕	tlc	tlc
嫉	guv	guv
帧	zhq	zhq
炆	xcw	xcw
炊	xnq	xnq
狷	pjv	pjv
眸	fof	fof
赎	quk	quk
顷	wty	wty
咝	jyy	jyy
懿	fan	fan
氯	toi	toi
呔	jkz	jkz
拭	hqe	hqe
珉	vbm	vbm
瘆	uoi	uoi
肱	vuo	vuo
莞	blk	blk
蚶	cyg	cyg
讳	ihw	ihw
豚	vrs	vrs
酯	zwd	zwd
镯	tcc	tcc
叟	ycr	ycr
蛰	hmc	hmc
倭	mwg	mwg
唾	jxt	jxt
枞	skk	skk
栾	qsm	qsm
毗	bxb	bxb
涝	oyi	oyi
玖	vqz	vqz
薰	bxs	bxs
钾	tgj	tgj
唑	jka	jka
峡	ems	ems
橹	szd	szd
瓮	tom	tom
窍	ree	ree
迦	ijo	ijo
鬓	ilt	ilt
侣	mjj	mjj
栎	syh	syh
棘	nnb	nnb
瞻	fqi	fqi
络	yog	yog
噫	jsn	jsn
妲	gbd	gbd
臻	gqw	gqw
仄	wkr	wkr
娑	ohg	ohg
敝	wlx	wlx
殊	xap	xap
甬	oey	oey
褶	lnn	lnn
辜	xfx	xfx
霏	rpf	rpf
兀	luu	luu
厥	wsn	wsn
嘲	juv	juv
檫	sll	sll
毡	ela	ela
涡	ojr	ojr
冢	crz	crz
玥	vvy	vvy
瞥	wlf	wlf
硪	uhq	uhq
剔	dfp	dfp
婕	gxh	gxh
巍	ewo	ewo
械	sqb	sqb
焊	xdk	xdk
祠	lwm	lwm
莽	bpb	bpb
萃	bpu	bpu
蜷	cmc	cmc
赟	ceq	ceq
嗟	jie	jie
嘱	jnr	jnr
峥	eqx	eqx
耄	awe	awe
膳	vij	vij
逄	lao	lao
醍	zdh	zdh
铢	tap	tap
峦	qes	qes
抑	hyc	hyc
晔	dmu	dmu
瑰	vgo	vgo
碌	uoi	uoi
箫	kxt	kxt
胚	vje	vje
蘼	bxp	bxp
谟	ilm	ilm
轧	pwe	pwe
鸢	qzn	qzn
黔	srw	srw
挎	hke	hke
箩	kcx	kcx
蚂	crm	crm
鄣	suf	suf
俑	moe	moe
汰	okz	okz
琥	vxb	vxb
谅	ich	ich
闽	ecc	ecc
饵	wfe	wfe
驮	rkd	rkd
鲤	zml	zml
嗄	jtl	jtl
埂	apg	apg
尧	qlu	qlu
恻	nqp	nqp
笫	kqk	kqk
凄	fxg	fxg
凋	fgq	fgq
尬	dkn	dkn
藻	qjs	qjs
饽	wfu	wfu
厢	wsf	wsf
攘	hyw	hyw
朔	sjv	sjv
箸	kae	kae
粹	dpu	dpu
镖	tul	tul
惴	neh	neh
昵	dnw	dnw
汹	ohg	ohg
淤	oyf	oyf
绾	yld	yld
荚	bms	bms
衔	ptj	ptj
俪	mev	mev
倡	mdd	mdd
咀	jkq	jkq
哓	jql	jql
嘁	jih	jih
寓	lbr	lbr
拗	hyi	hyi
搔	hrc	hrc
撰	hot	hot
桦	smu	smu
湮	oua	oua
笺	keq	keq
胞	vfo	vfo
赣	suq	suq
婧	gqv	gqv
嬉	gpj	gpj
庶	xux	xux
憎	nvd	nvd
萋	bxg	bxg
蟑	csu	csu
蹋	edn	edn
革	zgg	zgg
伎	mur	mur
埵	axt	axt
孚	aui	aui
挈	qph	qph
狭	pms	pms
簇	kyv	kyv
腱	vxo	vxo
蚤	rzc	rzc
黯	ssy	ssy
夯	kil	kil
宛	lxc	lxc
怔	nbe	nbe
榈	sej	sej
灼	xfz	xfz
瞠	fda	fda
祯	lhq	lhq
绚	yfd	yfd
褂	lvh	lvh
昙	dty	dty
毓	tng	tng
沏	ovp	ovp
渭	obv	obv
睾	aci	aci
耒	tsm	tsm
聆	frl	frl
膀	vky	vky
蕙	btn	btn
霁	rcn	rcn
涸	ogx	ogx
燎	xkh	xkh
篓	kdg	kdg
缚	ytu	ytu
胺	vlg	vlg
銮	qtj	qtj
掳	hxi	hxi
泫	opy	opy
灞	orv	orv
矜	crw	crw
筠	kaf	kaf
胱	vdl	vdl
腩	vui	vui
苡	bwk	bwk
裘	iyi	iyi
咎	lhj	lhj
姗	gyc	gyc
廓	xcf	xcf
抿	hbm	hbm
晟	diw	diw
桀	xas	xas
琐	vdq	vdq
眩	fpy	fpy
砚	uej	uej
秾	wcy	wcy
绢	yjv	yjv
迢	mod	mod
迩	qho	qho
酪	zog	zog
铐	tae	tae
镰	txn	txn
寮	lkh	lkh
愉	ngp	ngp
沱	olw	olw
浜	olt	olt
菁	bqv	bqv
毋	nuu	nuu
熠	xnn	xnn
熵	xkj	xkj
熹	pjx	pjx
筱	kml	kml
蟾	cqi	cqi
衷	yro	yro
洼	ovg	ovg
秽	wex	wex
稽	wdd	wdd
赦	anl	anl
佘	kls	kls
匣	agj	agj
婢	ggu	ggu
斐	pcw	pcw
殉	xfd	xfd
浔	oou	oou
濂	oxn	oxn
狙	pkq	pkq
筷	knk	knk
腓	vpf	vpf
蛀	czv	czv
蹿	err	err
飒	kbh	kbh
髂	dlo	dlo
剐	jrp	jrp
匾	azy	azy
妒	gzh	gzh
怵	nsz	nsz
焐	xvj	xvj
痂	uij	uij
硼	uvv	uvv
祢	lqh	lqh
芷	bji	bji
辖	plj	plj
逞	jvo	jvo
锕	tfx	tfx
冕	dzk	dzk
呓	jbw	jbw
宙	lgy	lgy
岌	erj	erj
幌	zdl	zdl
糍	dsy	dsy
茸	bfe	bfe
蝇	cju	cju
侉	mke	mke
嫔	glt	glt
戆	sun	sun
敖	qpl	qpl
槛	spc	spc
俘	mau	mau
垚	aaa	aaa
庾	xyk	xyk
晦	dtn	dtn
樯	sad	sad
纨	ymz	ymz
苛	bxk	bxk
蓓	bmj	bmj
蔷	bad	bad
蠃	pjc	pjc
迭	amo	amo
际	fls	fls
焰	xqy	xqy
璃	vpr	vpr
蕨	bwn	bwn
蛎	cwp	cwp
铞	tjz	tjz
颅	hnt	hnt
鱿	zdy	zdy
冽	fxp	fxp
啕	jfb	jfb
碴	usb	usb
蔼	bip	bip
谬	ini	ini
锰	tuc	tuc
姘	gsc	gsc
悄	ndv	ndv
柠	slr	slr
膻	vpb	vpb
诞	iao	iao
鄙	juf	juf
鞠	zfd	zfd
骟	rzn	rzn
髓	duo	duo
侦	mhq	mhq
吁	jeu	jeu
呤	jrl	jrl
瓤	yda	yda
磋	uie	uie
糁	doi	doi
谔	ide	ide
铉	tpy	tpy
镌	trv	trv
乓	lez	lez
佗	mlw	mlw
唵	jku	jku
嗫	jfr	jfr
囔	jfy	jfy
弼	iui	iui
猾	pdg	pdg
碚	ukj	ukj
芡	bnq	bnq
苷	byg	byg
麓	cal	cal
昇	dab	dab
竭	kdp	kdp
舛	xay	xay
铎	trh	trh
亢	pbj	pbj
寞	llm	llm
扼	hwc	hwc
搋	hwb	hwb
淞	oso	oso
甯	lne	lne
苕	bma	bma
葆	bms	bms
蚌	cqf	cqf
辙	ptl	ptl
醺	zxs	zxs
钊	tpd	tpd
柒	ovs	ovs
渚	oae	oae
肇	zlx	zlx
薏	bsn	bsn
覃	udu	udu
跺	ebs	ebs
氛	ttp	ttp
沛	onc	onc
猩	pdn	pdn
绗	ypx	ypx
谚	iki	iki
阙	esn	esn
唛	jql	jql
峤	emn	emn
构	sfo	sfo
樨	snf	snf
漕	oyd	oyd
澹	oqi	oqi
羔	ixh	ixh
蒿	bcg	bcg
姥	gaw	gaw
旬	fdr	fdr
缈	yfa	yfa
谀	iyk	iyk
驯	rgc	rgc
龇	ajw	ajw
婿	ghv	ghv
曳	dwa	dwa
漩	oyh	oyh
绯	ypf	ypf
霓	ryk	ryk
靳	zlj	zlj
骜	qpr	qpr
髋	dle	dle
喋	jus	jus
噬	jkk	jkk
扉	zpf	zpf
湛	oow	oow
炽	xjt	xjt
爰	aer	aer
犁	wpf	wpf
篡	kfo	kfo
肓	pvy	pvy
躬	gig	gig
亟	tje	tje
冏	gtj	gtj
剌	ppd	ppd
唳	jzp	jzp
恪	nog	nog
枷	sij	sij
焱	xxx	xxx
诀	iak	iak
锂	tml	tml
卞	phb	phb
彧	qim	qim
惩	kbn	kbn
耷	kfe	kfe
垠	amg	amg
愕	nde	nde
瑄	vlb	vlb
祁	lfe	lfe
祎	lhw	lhw
绰	yhu	yhu
阀	emq	emq
龌	ang	ang
宓	lna	lna
札	swe	swe
杈	srz	srz
栈	seq	seq
槐	sgo	sgo
殃	xgk	xgk
氦	tph	tph
芍	bfz	bfz
蛾	chq	chq
誊	miy	miy
骇	rph	rph
缆	ype	ype
蝗	cnv	cnv
跄	ekc	ekc
踉	ezm	ezm
镣	tkh	tkh
飨	yws	yws
鲞	mzv	mzv
傣	mqi	mqi
凛	fpl	fpl
卉	ubc	ubc
幡	zib	zib
廿	unn	unn
悼	nhu	nhu
撷	hqt	hqt
擂	hrb	hrb
桷	sqj	sqj
蜇	hlc	hlc
蹉	eie	eie
蹼	enz	enz
镀	txr	txr
偎	mby	mby
哞	jof	jof
漪	opx	opx
笳	kij	kij
膛	vda	vda
诳	ipv	ipv
骡	rby	rby
鳌	qpz	qpz
鼋	tku	tku
侄	mgi	mgi
咤	jlv	jlv
悯	nec	nec
捌	hjp	hjp
涤	ols	ols
稗	wgu	wgu
宦	lec	lec
帜	zjt	zjt
惕	ndi	ndi
掠	hch	hch
曜	dnr	dnr
琏	vpo	vpo
蛭	cgi	cgi
酚	ztp	ztp
呒	jcu	jcu
嵘	eys	eys
忿	tpn	tpn
恍	ndl	ndl
捺	hkl	hkl
揸	hsb	hsb
汶	ocw	ocw
洽	ogh	ogh
涣	oqk	oqk
矶	ubj	ubj
臊	vjs	vjs
钚	tjb	tjb
僻	mnf	mnf
儆	mbl	mbl
愧	ngo	ngo
敞	djl	djl
榻	sdn	sdn
槿	szt	szt
涟	opo	opo
鄱	ibf	ibf
鹜	clz	clz
殡	xlt	xlt
溥	otu	otu
羁	czr	czr
荧	yxh	yxh
葩	bno	bno
仃	mrd	mrd
偕	mxn	mxn
哂	jux	jux
唁	jiy	jiy
惮	nvu	nvu
扈	zjo	zjo
攸	mlx	mlx
桨	yxs	yxs
绔	yke	yke
肆	ixv	ixv
莰	ban	ban
袒	lbd	lbd
锄	tki	tki
霰	rul	rul
侗	mgm	mgm
嬷	gxo	gxo
帛	nzj	nzj
戮	nkq	nkq
漠	olm	olm
狡	pfh	pfh
缳	ycy	ycy
莳	bdu	bdu
跤	efh	efh
邑	job	job
锃	tjv	tjv
饴	woj	woj
鳝	zij	zij
噼	jnf	jnf
垃	akl	akl
掣	fzh	fzh
簧	kug	kug
胫	vre	vre
腋	vpl	vpl
赭	ana	ana
踵	exm	exm
邰	ojf	ojf
噤	jcl	jcl
姊	gqk	gqk
庥	xms	xms
昼	nzb	nzb
柑	syg	syg
渥	ong	ong
湜	odh	odh
炷	xzv	xzv
狲	puh	puh
矩	vaa	vaa
绽	ylh	ylh
罡	cbe	cbe
诓	iav	iav
遢	dno	dno
吝	cjk	cjk
哝	jcy	jcy
囫	gfi	gfi
囵	gkw	gkw
宸	lzc	lzc
怼	run	run
椿	sqd	sqd
樾	sdi	sdi
氰	tqv	tqv
泸	ohn	ohn
洺	oxj	oxj
牒	yus	yus
猹	psb	psb
筏	kmq	kmq
苋	bej	bej
衿	lrw	lrw
讪	ies	ies
趸	epe	epe
唏	jhz	jhz
壤	ayw	ayw
楣	snf	snf
澎	opi	opi
牡	fat	fat
瘩	ubg	ubg
谶	ike	ike
锵	tyu	tyu
隼	rus	rus
凰	bnv	bnv
堑	pla	pla
弛	idy	idy
暧	dir	dir
槌	sao	sao
烁	xyh	xyh
煦	dsx	dsx
瑷	vir	vir
璟	vxj	vxj
粢	fnd	fnd
菩	bkj	bkj
谏	ips	ips
辐	pmb	pmb
钼	tfm	tfm
锝	tbu	tbu
锹	twx	twx
阚	ewl	ewl
伲	mnw	mnw
埠	aau	aau
萁	boq	boq
葭	bnr	bnr
蓖	bsx	bsx
衮	yto	yto
骸	dph	dph
鹃	jvz	jvz
鹫	chz	chz
仝	keg	keg
俳	mpf	mpf
啮	jac	jac
嗌	jsc	jsc
嘹	jkh	jkh
嵊	eww	eww
徊	kdh	kdh
掼	hnq	hnq
揩	hxn	hxn
檬	syr	syr
沌	oej	oej
焯	xhu	xhu
缎	yht	yht
跎	elw	elw
铡	tqp	tqp
麂	abj	abj
厩	wmc	wmc
墟	axn	axn
惺	ndn	ndn
撼	hin	hin
洵	ofd	ofd
腆	vyt	vyt
赊	qkl	qkl
踝	ebs	ebs
钣	twr	twr
铠	tea	tea
鹳	bdz	bdz
冗	cbj	cbj
吏	mhi	mhi
屉	nuw	nuw
帚	ocz	ocz
悱	npf	npf
昀	dff	dff
昶	zid	zid
朽	sek	sek
梧	svj	svj
汛	owu	owu
沦	okw	okw
洱	ofe	ofe
犀	nif	nif
畸	bkx	bkx
疽	ukq	ukq
祉	lji	lji
笤	kma	kma
粲	xrd	xrd
藜	bwi	bwi
鞑	zko	zko
韭	pei	pei
颉	qty	qty
髌	dlt	dlt
惬	nas	nas
汐	oxx	oxx
爻	hhi	hhi
箔	kon	kon
腑	vxu	vxu
蝼	cdg	cdg
阑	eps	eps
倘	mdj	mdj
悭	npa	npa
慑	nfr	nfr
摹	lhs	lhs
毽	exo	exo
淮	oru	oru
狨	pqu	pqu
瓯	ahm	ahm
祗	lyz	lyz
祷	lqu	lqu
耨	tsu	tsu
芈	bhs	bhs
褐	ldp	ldp
钴	txg	txg
锷	tde	tde
镚	tev	tev
霭	rip	rip
佶	mqj	mqj
刈	hpd	hpd
呋	jmf	jmf
怦	nks	nks
曙	dca	dca
涪	okj	okj
淅	osl	osl
珑	vzl	vzl
珺	voj	voj
篆	kor	kor
篑	kcq	kcq
绸	ygq	ygq
褥	lzu	lzu
诏	ima	ima
践	eeq	eeq
踟	evj	evj
蹰	ewu	ewu
鳐	zab	zab
刍	qow	qow
啜	jrr	jrr
屐	nkr	nkr
怏	ngk	ngk
懑	obn	obn
揖	hjf	hjf
摒	hnc	hnc
檄	snl	snl
潞	oeo	oeo
犸	prm	prm
聿	xvv	xvv
荃	bkv	bkv
蓦	lrm	lrm
铀	tgy	tgy
铖	tiw	tiw
堰	aag	aag
嫡	gkx	gkx
孺	urh	urh
怠	ojn	ojn
斡	udl	udl
旮	mdr	mdr
甪	aey	aey
盔	uxc	uxc
紊	cys	cys
翡	pnv	pnv
臆	vsn	vsn
蔽	bwl	bwl
蜍	ckw	ckw
劁	rxp	rxp
叱	jwb	jwb
夥	bsx	bsx
孢	ufo	ufo
惦	nxl	nxl
渎	ouk	ouk
痿	uwg	uwg
睦	faa	faa
羌	iwe	iwe
舆	ypt	ypt
茑	bzn	bzn
蕲	bvl	bvl
诌	iqo	iqo
邕	gjo	gjo
酰	zfk	zfk
阄	equ	equ
隙	fhh	fhh
馗	msd	msd
髻	iqj	iqj
齉	dby	dby
剋	xkp	xkp
匮	acq	acq
啡	jpf	jpf
妨	gyf	gyf
姹	glv	glv
曈	dkm	dkm
沣	oqf	oqf
熔	xlc	xlc
玹	vpy	vpy
疟	uow	uow
疸	ubd	ubd
矍	ffr	ffr
纰	yxb	yxb
蜱	cgu	cgu
辄	pfw	pfw
鏖	atj	atj
铄	tyh	tyh
阆	ezm	ezm
陇	fzl	fzl
陲	fxt	fxt
隶	xis	xis
鳟	zzu	zzu
圜	gcy	gcy
幔	zqm	zqm
挟	hms	hms
昱	dkl	dkl
疙	utw	utw
纣	yuc	yuc
跬	evg	evg
鞘	zdv	zdv
嗞	jsy	jsy
惭	npl	npl
桎	sgi	sgi
梏	sfj	sfj
榭	sgu	sgu
疝	ues	ues
硒	uux	uux
罹	cnr	cnr
耪	tsy	tsy
薅	bgu	bgu
衅	ach	ach
颀	lty	lty
飏	bhi	bhi
骛	clr	clr
黟	sxx	sxx
坷	axk	axk
尕	vhx	vhx
峻	eol	eol
彷	kyf	kyf
忤	ntu	ntu
戎	quy	quy
戟	udq	udq
掬	hfd	hfd
柘	sus	sus
橼	syr	syr
涐	ohq	ohq
炬	xaa	xaa
熘	xyb	xyb
玑	vbj	vbj
琶	vvo	vvo
畿	yyb	yyb
疚	uqz	uqz
砭	uab	uab
绅	yds	yds
莼	byj	byj
菀	blc	blc
跹	exo	exo
蹁	ezy	ezy
逍	dvo	dvo
颚	det	det
颦	jhu	jhu
飕	bhr	bhr
鹊	udz	udz
佯	miy	miy
囿	guv	guv
戕	yqg	yqg
汲	orj	orj
涿	orz	orz
癞	upq	upq
眺	fkf	fkf
篷	klo	klo
糨	dic	dic
缉	yjf	yjf
翕	gnv	gnv
肄	wvx	wvx
芨	brj	brj
蔗	bxx	bxx
貉	pog	pog
趺	emf	emf
阐	evu	evu
雹	rfo	rfo
靛	qvh	qvh
骊	rev	rev
骞	lwr	lwr
坳	ayi	ayi
岷	ebm	ebm
帷	zru	zru
捩	hzp	hzp
擢	hnr	hnr
斛	qld	qld
泗	ocs	ocs
洹	oeb	oeb
滁	ofw	ofw
猝	ppu	ppu
疖	ucj	ucj
稼	wlr	wlr
袂	lak	lak
訇	fiy	fiy
讽	ibh	ibh
邈	pno	pno
阖	eac	eac
鸾	qzn	qzn
龊	aeu	aeu
倌	mld	mld
偃	mag	mag
凇	fso	fso
募	lil	lil
尢	dyy	dyy
抒	hcv	hcv
昴	dym	dym
枳	sjt	sjt
桉	slg	slg
楸	swx	swx
煌	xnv	xnv
獾	pbr	pbr
眶	fav	fav
砺	uwp	uwp
箬	kbu	kbu
缨	yqg	yqg
羿	nbc	nbc
翀	nro	nro
诬	iek	iek
豇	aeg	aeg
豳	err	err
铤	tvo	tvo
闾	ejj	ejj
韶	sma	sma
骥	ryt	ryt
鲑	zvg	zvg
丐	ehw	ehw
哮	jau	jau
塾	cua	cua
尉	nlu	nlu
晌	dsj	dsj
汴	oph	oph
珰	vdo	vdo
琢	vrz	vrz
甑	vdm	vdm
綦	oys	oys
绪	yae	yae
羟	ire	ire
羸	pji	pji
茼	bgm	bgm
豢	mrs	mrs
跚	eyc	eyc
蹒	ebk	ebk
釜	tht	tht
亳	cav	cav
仞	mpz	mpz
偲	mbn	mbn
劾	pil	pil
勐	uci	uci
哕	jex	jex
奘	yak	yak
崂	eyi	eyi
惘	ngp	ngp
搡	hrs	hrs
玺	qhl	qhl
瘢	ult	ult
祕	lna	lna
绺	ylj	ylj
耦	tsr	tsr
臼	yjj	yjj
苜	bfm	bfm
茕	ywu	ywu
荞	bmn	bmn
蓿	blu	blu
蔬	bhg	bhg
谙	isy	isy
遏	dfo	dfo
钡	tqb	tqb
铪	tgh	tgh
驷	rcs	rcs
麸	qlm	qlm
佣	mey	mey
佻	mkf	mkf
剜	lxp	lxp
咨	fnj	fnj
妣	gxb	gxb
徵	kvw	kvw
悖	nfu	nfu
樵	srx	srx
猥	pby	pby
畀	blu	blu
绻	ymc	ymc
缱	yco	yco
萤	ycc	ycc
藐	bpk	bpk
衾	rwy	rwy
豺	pua	pua
贿	quv	quv
迤	tdo	tdo
逶	wgo	wgo
饲	wwm	wwm
黠	sqj	sqj
咆	jfo	jfo
圙	gtt	gtt
娣	gsq	gsq
彘	oww	oww
惚	nfn	nfn
掸	hvu	hvu
攮	hfy	hfy
斟	owl	owl
晁	dkf	dkf
橡	szx	szx
殁	xts	xts
浏	ocp	ocp
漳	osu	osu
纷	ytp	ytp
臧	iec	iec
舶	lnb	lnb
芫	btk	btk
苣	baa	baa
荇	bpx	bpx
荽	bag	bag
莴	bjr	bjr
虻	cpw	cpw
诲	itn	itn
蹚	eda	eda
铂	tnb	tnb
馓	wul	wul
鲎	dzv	dzv
鹀	ekz	ekz
圐	gcy	gcy
姻	ggk	ggk
娈	qgn	qgn
尴	dpc	dpc
恿	oen	oen
溆	okr	okr
玚	vwi	vwi
琨	vdx	vdx
璨	vxd	vxd
疱	ufo	ufo
睐	fps	fps
祐	luy	luy
缮	yij	yij
胳	vog	vog
蚜	cay	cay
蠡	orc	orc
觜	jwq	jwq
讴	iah	iah
贻	qoj	qoj
跛	ezp	ezp
蹊	eak	eak
蹙	iie	iie
迸	sco	sco
醛	zbv	zbv
鞅	zgk	zgk
颞	frt	frt
龋	aar	aar
佺	mkv	mkv
嗽	jpn	jpn
彝	odb	odb
怆	nkc	nkc
慨	nmc	nmc
檎	skr	skr
殖	xni	xni
湍	oeh	oeh
獴	pyr	pyr
琯	vld	vld
瞿	ffr	ffr
裳	djy	djy
诙	iux	iux
辍	prr	prr
酵	zau	zau
镊	tfr	tfr
麒	aoq	aoq
仟	mxq	mxq
僚	mkh	mkh
媾	gwa	gwa
孖	uui	uui
崮	egx	egx
巽	oot	oot
懈	nqf	nqf
柬	psb	psb
桠	sen	sen
涓	ojv	ojv
焙	xkj	xkj
琰	vxx	vxx
砗	upc	upc
磲	uos	uos
艿	bvn	bvn
蚬	cej	cej
襄	ydw	ydw
乸	dnm	dnm
侑	muv	muv
剿	gbp	gbp
埔	atf	atf
奚	ayk	ayk
岱	mqe	mqe
幛	zsu	zsu
湎	otm	otm
潋	ogl	ogl
猡	pcx	pcx
瓴	rmw	rmw
癜	unt	unt
盱	feu	feu
眙	foj	foj
祟	jgl	jgl
糅	dcs	dcs
缔	ykz	ykz
舐	fyv	fyv
茴	bdh	bdh
莒	bjj	bjj
蓑	byt	byt
裾	lnx	lnx
谧	inc	inc
踱	exr	exr
遑	nvo	nvo
阪	fwr	fwr
馐	wia	wia
骝	ryb	ryb
鹄	fjz	fjz
麾	xce	xce
伥	mic	mic
侪	mcn	mcn
呶	jgr	jgr
堃	yya	yya
妤	gcv	gcv
岬	egj	egj
峪	ecg	ecg
弋	qii	qii
悻	nai	nai
愠	ndc	ndc
旻	dcw	dcw
殒	xjq	xjq
沭	osz	osz
湄	onf	onf
滘	ocj	ocj
烽	xlq	xlq
獭	ppq	ppq
砷	uds	uds
祼	lbs	lbs
粕	dnb	dnb
胛	vgj	vgj
胴	vgm	vgm
舷	lpy	lpy
莘	bfx	bfx
莜	bml	bml
蕖	bos	bos
谲	icj	icj
醪	zni	zni
锚	tbb	tbb
饯	weq	weq
黢	sol	sol
偌	mbu	mbu
吩	jtp	jtp
喙	jor	jor
夙	bxd	bxd
峭	edv	edv
愀	nwx	nwx
汆	kis	kis
牦	fem	fem
瑗	var	var
瘠	ufv	ufv
籁	kpq	kpq
缭	ykh	ykh
罘	cjb	cjb
翎	rnv	rnv
蒹	bsn	bsn
螳	cda	cda
衙	pvj	pvj
袆	lhw	lhw
襦	lrh	lrh
诧	ilv	ilv
诽	ipf	ipf
谕	igp	igp
赍	fkq	fkq
锻	tht	tht
饕	jew	jew
鬃	ill	ill
鲠	zpg	zpg
鳃	zbn	zbn
倜	mgq	mgq
傥	mdk	mdk
劼	qil	qil
婠	gld	gld
峒	egm	egm
崆	ere	ere
怛	nbd	nbd
柩	saz	saz
楔	sqk	sqk
泔	oyg	oyg
瀛	opg	opg
爨	ygx	ygx
玦	vak	vak
痹	ubl	ubl
睥	fgu	fgu
睨	fyk	fyk
茚	byc	byc
蜕	cvk	cvk
谥	isc	isc
貘	plm	plm
邋	gyo	gyo
邳	jef	jef
饹	wog	wog
驽	grr	grr
䁖	fdg	fdg
丞	wie	wie
俎	kkk	kkk
俶	mir	mir
峋	efd	efd
嶙	eda	eda
嶷	ewh	ewh
徘	kpf	kpf
栲	sae	sae
栳	saw	saw
皙	sln	sln
砀	uwi	uwi
纾	ycv	ycv
绦	yls	yls
芜	bcu	bcu
芩	brw	brw
茫	qpw	qpw
葺	bjf	bjf
蛱	cms	cms
贮	qle	qle
邨	ejf	ejf
醐	zxv	zxv
铱	tyi	tyi
镲	tll	tll
饸	wgh	wgh
驸	rmu	rmu
鹟	toz	toz
麝	agu	agu
黜	sjg	sjg
龅	afo	afo
佝	msj	msj
佼	mfh	mfh
侮	mtn	mtn
俸	mqh	mqh
偻	mdg	mdg
厍	wpc	wpc
嘌	jul	jul
噙	jkr	jkr
嬗	gpb	gpb
岐	eur	eur
峨	ehq	ehq
嵋	enf	enf
忾	ntq	ntq
惇	ncu	ncu
暝	dcf	dcf
椴	sht	sht
椹	sow	sow
汕	oes	oes
沆	opb	opb
浚	ool	ool
淦	otj	otj
溧	ous	ous
瀣	oxe	oxe
烯	xhz	xhz
簌	kpn	kpn
脘	vlk	vlk
腭	vde	vde
荀	bfd	bfd
虔	xcw	xcw
蜚	pcc	pcc
蜥	csl	csl
裢	lpo	lpo
褡	lbg	lbg
踅	hle	hle
邸	yvf	yvf
锆	tfj	tfj
陂	fzp	fzp
魍	gop	gop
龛	gzl	gzl
妯	ggy	ggy
娆	gql	gql
娌	gml	gml
弁	obc	obc
弈	qbc	qbc
徜	kdj	kdj
榄	spe	spe
泓	oio	oio
涎	oao	oao
狈	pqb	pqb
瘘	udg	udg
瘴	usu	usu
盂	euc	euc
砥	uyz	uyz
硚	umn	umn
腙	vll	vll
荻	bpx	bpx
蔑	bcz	bcz
裨	lgu	lgu
谝	izy	izy
赘	qpq	qpq
邝	xfe	xfe
镬	tbr	tbr
馃	wbs	wbs
骓	rru	rru
乂	hii	hii
伉	mpb	mpb
僭	mcd	mcd
儋	mqi	mqi
啉	jcl	jcl
垭	aen	aen
埕	ajv	ajv
娲	gjr	gjr
嫚	gqm	gqm
孀	grf	grf
崃	eps	eps
桡	sql	sql
殆	xoj	xoj
泮	osh	osh
漯	oby	oby
潺	onu	onu
濒	ojt	ojt
璜	vug	vug
疵	ujw	ujw
硐	ugm	ugm
箧	kas	kas
绀	yyg	yyg
缶	bff	bff
萸	byk	byk
蒡	bky	bky
螃	cky	cky
觥	qdl	qdl
豉	aur	aur
趄	dkq	dkq
趔	dxp	dxp
跐	ejw	ejw
蹴	ecd	ecd
邛	efe	efe
锭	tlh	tlh
驭	rry	rry
髅	ddg	ddg
鸳	xcz	xcz
仂	mil	mil
嫪	gni	gni
忪	nto	nto
慷	nxi	nxi
憷	nch	nch
摈	hlt	hlt
椽	sor	sor
榧	sap	sap
毐	anu	anu
毳	eee	eee
沓	idr	idr
沩	ozz	ozz
淀	olh	olh
碣	udp	udp
缦	yqm	yqm
罄	anb	anb
翮	unv	unv
胬	grk	grk
膺	xmv	xmv
蛳	cpz	cpz
贲	ubq	ubq
迂	euo	euo
锱	tgb	tgb
镂	tdg	tdg
镉	tug	tug
镫	tta	tta
馄	wdx	wdx
俅	miq	miq
叵	ajk	ajk
喱	jwm	jwm
噘	jwn	jwn
奂	qgk	qgk
妪	gah	gah
廪	xpl	xpl
掮	hzv	hzv
旸	dwi	dwi
栊	szl	szl
椟	suk	suk
沤	oah	oah
潸	ocv	ocv
烷	xlk	xlk
牯	fxg	fxg
瑙	vgh	vgh
瞑	fcf	fcf
笕	kej	kej
绌	yjg	yjg
缛	yzu	yzu
缤	ylt	ylt
羚	irl	irl
翌	nkl	nkl
舂	qyj	qyj
艏	lsd	lsd
蒗	qzm	qzm
蚩	jec	jec
蛟	cfh	cfh
讼	ito	ito
醅	zkj	zkj
钥	tvy	tvy
铳	ttk	ttk
颏	pty	pty
馒	wqm	wqm
魇	wpo	wpo
傈	mus	mus
僳	mud	mud
嗐	jlj	jlj
噩	vdd	vdd
垡	mqa	mqa
壑	xca	xca
惰	nuv	nuv
挲	ohh	ohh
旖	ytx	ytx
桢	shq	shq
溟	ocf	ocf
滟	oqo	oqo
燔	xib	xib
牍	yuk	yuk
犍	fxo	fxo
狍	pfo	pfo
玟	vcw	vcw
痢	uwp	uwp
缙	yed	yed
荟	bkt	bkt
荪	buh	buh
蒺	buv	buv
蚰	cgy	cgy
蜒	cao	cao
诘	iqj	iqj
谒	idp	idp
轼	pqe	pqe
辗	pny	pny
遐	nto	nto
鄢	bef	bef
钜	taa	taa
锑	tsq	tsq
镗	tda	tda
陨	fjq	fjq
鲛	zfh	zfh
鹞	abz	abz
侩	mkt	mkt
僦	mcd	mcd
圩	aeu	aeu
坻	ayz	ayz
埗	ajh	ajh
忖	nuc	nuc
攫	hfr	hfr
氐	yvz	yvz
潼	okm	okm
琇	vwv	vwv
畴	bqu	bqu
瘊	umv	umv
眦	fjw	fjw
睚	fwv	fwv
碓	uru	uru
笏	kfi	kfi
翊	knv	knv
胍	vag	vag
茉	bpm	bpm
莠	bwv	bwv
蛄	cxg	cxg
蝈	cgl	cgl
蝰	ckv	ckv
蟀	cpu	cpu
褛	ldg	ldg
褴	lpc	lpc
讥	ibj	ibj
蹩	wle	wle
轭	pwc	pwc
遒	zod	zod
酊	zrd	zrd
酩	zxj	zxj
醨	zpr	zpr
隈	fby	fby
隘	fsc	fsc
雎	kru	kru
鳗	zqm	zqm
鹾	lhe	lhe
咥	jgi	jgi
哌	jwy	jwy
嗵	joo	joo
埤	agu	agu
嫫	glm	glm
愎	ntl	ntl
戗	kcq	kcq
敕	plx	plx
旌	ytn	ytn
梿	spo	spo
棹	shu	shu
榫	sru	sru
泱	ogk	ogk
瘐	uyk	uyk
盎	gkc	gkc
睫	fxh	fxh
祜	lxg	lxg
稹	wnt	wnt
罂	qqb	qqb
羧	iol	iol
肴	huv	huv
芎	big	big
菂	bnz	bnz
蚴	cyi	cyi
蜈	cjm	cjm
蟠	cib	cib
轳	phn	phn
辘	pal	pal
醴	zya	zya
钕	tgn	tgn
铍	tzp	tzp
铵	tlg	tlg
锎	tec	tec
骅	rmu	rmu
鬣	igy	igy
仉	mbj	mbj
俵	mqy	mqy
冼	ffk	ffk
咴	jux	jux
哙	jkt	jkt
哽	jpg	jpg
唿	jfn	jfn
喟	jbv	jbv
崛	eng	eng
嵛	egp	egp
憧	nkm	nkm
戋	eqg	eqg
捍	hdk	hdk
晡	dtf	dtf
枧	sej	sej
槎	sie	sie
歃	xyn	xyn
氘	tnd	tnd
溴	odp	odp
煜	xdk	xdk
爿	ypp	ypp
犇	fff	fff
犒	fcg	fcg
皴	otz	otz
睑	fgd	fgd
瞰	fwl	fwl
稞	wbs	wbs
窸	rin	rin
筜	kdo	kdo
筼	kjq	kjq
芣	bjb	bjb
荜	bxu	bxu
蟥	cug	cug
衢	pfr	pfr
诤	iqx	iqx
谠	idk	idk
蹇	lwe	lwe
酢	zra	zra
钺	tiu	tiu
镍	tds	tds
镓	tlr	tlr
镭	trb	trb
隍	fnv	fnv
靥	wpt	wpt
顼	vty	vty
颛	eht	eht
髎	dni	dni
鳍	zad	zad
鸰	rzn	rzn
兢	xkk	xkk
呣	jnm	jnm
囹	grl	grl
圄	gvj	gvj
圻	alj	alj
垞	alv	alv
垩	ena	ena
埙	ajq	ajq
夔	sdl	sdl
姒	gwk	gwk
嵇	wde	wde
弭	ife	ife
怄	nah	nah
悚	nps	nps
懦	nrh	nrh
戢	jfq	jfq
拮	hqj	hqj
昉	dyf	dyf
晞	dhz	dhz
杼	scv	scv
榉	sdh	sdh
殚	xvu	xvu
殳	tss	tss
沅	otk	otk
漓	opr	opr
濡	orh	orh
炀	xwi	xwi
炔	xak	xak
烬	xnf	xnf
燊	xxs	xxs
猢	pxv	pxv
玘	vaj	vaj
琵	vvx	vvx
癿	nwe	nwe
眭	fvg	fvg
瞋	fnt	fnt
窿	rfn	rfn
纮	yuo	yuo
耋	awg	awg
胩	vih	vih
脞	vka	vka
莆	btf	btf
蓼	bni	bni
蘑	bxu	bxu
蜃	zcc	zcc
袪	lao	lao
觐	zte	zte
诂	ixg	ixg
谡	ibl	ibl
赑	qqq	qqq
跖	eus	eus
踞	enx	enx
踯	esf	esf
躅	ecc	ecc
迥	gjo	gjo
酐	zkg	zkg
钯	tob	tob
铯	tqo	tqo
颧	bdt	bdt
馇	wsb	wsb
骺	dwm	dwm
鲔	zuv	zuv
鸮	jez	jez
鸯	gkz	gkz
鹗	dez	dez
鹩	ksz	ksz
黩	suk	suk
丕	jei	jei
乩	lwe	lwe
亘	ebd	ebd
伺	mwm	mwm
俟	mov	mov
劢	epi	epi
匕	wbb	wbb
呻	jds	jds
咇	jna	jna
喈	jxn	jxn
噱	jxr	jxr
嚏	jfh	jfh
圾	arj	arj
奠	zkd	zkd
彳	kcc	kcc
忏	nxq	nxq
扦	hxq	hxq
扽	hej	hej
挚	hmh	hmh
昝	lhd	lhd
晰	dsl	dsl
楫	sjf	sjf
淄	ogb	ogb
潴	opa	opa
皋	nku	nku
碛	une	une
秩	wam	wam
稔	wrn	wrn
翩	zyn	zyn
耧	tsg	tsg
芗	byx	byx
荠	bcn	bcn
蒐	bgo	bgo
藿	brr	brr
蘖	bas	bas
蝠	cmb	cmb
衽	lvw	lvw
褙	lyv	lyv
觑	xne	xne
诅	ikq	ikq
诒	ioj	ioj
辔	ypj	ypj
鄞	ztf	ztf
醚	zdo	zdo
醯	ztc	ztc
钏	tgc	tgc
霈	roc	roc
霹	rnf	rnf
韪	dhh	dhh
饷	wsj	wsj
骐	roq	roq
魉	gok	gok
鳎	zdn	zdn
鳔	zul	zul
鸵	zlw	zlw
龈	amg	amg
㑇	mqo	mqo
㑊	mqi	mqi
㕮	jth	jth
㘎	jel	jel
㙍	arr	arr
㙘	aug	aug
㙦	kwa	kwa
㛃	qpg	qpg
㛚	goe	goe
㛹	gmp	gmp
㟃	ewm	ewm
㠇	ecd	ecd
㠓	eyr	eyr
㤘	nqo	nqo
㥄	nal	nal
㧐	hrs	hrs
㧑	hzz	hzz
㧟	hoa	hoa
㫰	dzm	dzm
㬊	dar	dar
㬎	dyx	dyx
㬚	dtl	dtl
㭎	sgh	sgh
㭕	sao	sao
㮾	zms	zms
㰀	swi	swi
㳇	oth	oth
㳘	otk	otk
㳚	oiz	oiz
㴔	oqn	oqn
㵐	own	own
㶲	xey	xey
㸆	xfp	xfp
㸌	xrr	xrr
㺄	pgp	pgp
㻬	vre	vre
㽏	ogy	ogy
㿠	ndl	ndl
䂮	qpu	qpu
䃅	uvu	uvu
䃎	ukx	ukx
䅟	woi	woi
䌹	ygj	ygj
䎃	gan	gan
䎖	vdn	vdn
䏝	vtz	vtz
䏡	vls	vls
䏲	vsq	vsq
䐃	vgw	vgw
䓖	bri	bri
䓛	bng	bng
䓨	ybf	ybf
䓫	bkx	bkx
䓬	bhu	bhu
䗖	cyz	cyz
䗛	cmv	cmv
䗪	xuc	xuc
䗴	cko	cko
䜣	ilj	ilj
䝙	pah	pah
䢺	jgf	jgf
䢼	utf	utf
䣘	djf	djf
䥽	tjr	tjr
䦃	tba	tba
䲟	zyc	zyc
䲠	zqd	zqd
䲢	vmz	vmz
䴓	ezz	ezz
䴔	fhz	fhz
䴕	xpz	xpz
䴖	qvz	qvz
䴗	fpz	fpz
䴘	wxz	wxz
䴙	njz	njz
䶮	zmt	zmt
丏	ecw	ecw
亍	kcc	kcc
亓	elu	elu
亵	yhz	yhz
亶	pdb	pdb
亸	cuu	cuu
亹	pyk	pyk
仡	mtw	mtw
仫	mao	mao
仳	mxb	mxb
仵	mtu	mtu
伈	mnx	mnx
伋	mrj	mrj
伛	mah	mah
伣	mej	mej
伧	mkc	mkc
伫	mle	mle
伭	mpy	mpy
伾	mje	mje
佁	moj	moj
佃	mbt	mbt
佖	mna	mna
佚	mam	mam
佞	mtg	mtg
佤	mmw	mmw
佥	gdd	gdd
佴	mfe	mfe
佸	mfs	mfs
佽	mfn	mfn
佾	mtv	mtv
侁	mfk	mfk
侂	mxv	mxv
侈	mxx	mxx
侏	map	map
侔	mof	mof
侘	mlv	mlv
侥	mql	mql
侴	gwp	gwp
侹	mvo	mvo
俍	mzm	mzm
俙	mhz	mhz
俜	mge	mge
俣	mjm	mjm
俦	mqu	mqu
俨	mew	mew
俫	mps	mps
倓	mxx	mxx
倕	mxt	mxt
倞	mch	mch
倥	mre	mre
倧	mll	mll
倨	mnx	mnx
倬	mhu	mhu
倮	mbs	mbs
倴	mkb	mkb
倻	mff	mff
偁	maa	maa
偓	mng	mng
偡	mow	mow
偬	mfn	mfn
偭	mtm	mtm
偰	mqk	mqk
偾	muq	muq
傀	mgo	mgo
傃	mqy	mqy
傉	mzu	mzu
傒	mak	mak
傕	mcr	mcr
傧	mlt	mlt
傩	mrr	mrr
傺	mtl	mtl
僇	mni	mni
僎	mot	mot
僔	mzu	mzu
僖	mpj	mpj
僬	mrx	mrx
僮	mkm	mkm
僰	nnk	nnk
儇	mcy	mcy
儡	mbb	mbb
儦	max	max
儳	mzz	mzz
儴	myw	myw
兕	glu	glu
兖	fok	fok
冁	vuy	vuy
冔	dju	dju
冮	feg	feg
冱	feo	feo
凓	fus	fus
凘	fol	fol
凫	zbj	zbj
凼	igk	igk
刎	fip	fip
刖	vpd	vpd
刬	eqp	eqp
刭	rep	rep
刳	kep	kep
刽	ktp	ktp
刿	exp	exp
剀	eap	eap
剅	apd	apd
剕	ppd	ppd
剞	kxp	kxp
剟	rrp	rrp
剡	xxp	xxp
劂	wsp	wsp
劄	kgp	kgp
劐	brp	brp
劓	dbp	dbp
劬	sil	sil
劭	mil	mil
勍	chi	chi
勔	til	til
勖	dfi	dfi
勚	uwi	uwi
勠	nki	nki
勰	iin	iin
匆	fiz	fiz
匈	fhg	fhg
匍	ftf	ftf
匏	keo	keo
匐	fmb	fmb
匜	ady	ady
匦	apm	apm
匼	agh	agh
卣	lak	lak
卬	ycj	ycj
卮	wec	wec
卺	wic	wic
厖	wui	wui
厣	wpg	wpg
厾	wao	wao
叆	tir	tir
叇	txo	txo
叕	rrs	rrs
叚	ntr	ntr
吣	jnx	jnx
吲	jic	jic
呇	ijk	ijk
呖	jwi	jwi
呙	jrn	jrn
咄	jjg	jjg
咉	jgk	jgk
咍	joj	joj
咐	jmu	jmu
咙	jzl	jzl
咡	jfe	jfe
咫	nzt	nzt
咺	jeb	jeb
哃	jgm	jgm
哚	jbs	jbs
哢	jvb	jvb
哱	jfu	jfu
哳	jhl	jhl
哿	ijx	ijx
唝	jeq	jeq
唢	jdq	jdq
唣	jnv	jnv
唪	jqh	jqh
唼	jkg	jkg
啁	jgq	jgq
啬	asd	asd
啭	jpz	jpz
啴	jvu	jvu
啶	jlh	jlh
啻	kzj	kzj
喁	jbr	jbr
喑	jsy	jsy
喤	jnv	jnv
喹	jkv	jkv
喾	dfj	dfj
嗉	jqy	jqy
嗍	jsv	jsv
嗥	jnu	jnu
嗪	jqw	jqw
嗾	jyv	jyv
嘏	xnr	xnr
嘡	jda	jda
嘧	jle	jle
噀	jot	jot
噂	jzu	jzu
噇	jkm	jkm
噍	jrx	jrx
嚅	jrh	jrh
嚆	jbc	jbc
嚚	ded	ded
嚭	pjj	pjj
囟	shi	shi
囱	slx	slx
囷	gwh	gwh
圉	gai	gai
圊	gqv	gqv
圌	geh	geh
圢	ard	ard
圪	atw	atw
圫	aav	aav
圬	aee	aee
圮	aaj	aaj
圯	aos	aos
圲	axq	axq
圳	agc	agc
圹	axg	axg
坉	aej	aej
坋	atp	atp
坌	tpa	tpa
坒	xat	xat
坜	awi	awi
坥	akq	akq
坩	ayg	ayg
坫	ala	ala
坬	aag	aag
坭	anw	anw
坰	agj	agj
坼	alz	alz
坽	arl	arl
垄	zat	zat
垆	ahn	ahn
垈	mqa	mqa
垌	agm	agm
垍	adi	adi
垎	aog	aog
垏	axv	axv
垓	aph	aph
垕	wma	wma
垙	adl	adl
垟	aiy	aiy
垤	agi	agi
垧	asj	asj
垯	ako	ako
垱	ado	ado
垲	aea	aea
垴	apg	apg
垸	alk	alk
垺	aau	aau
垾	adk	adk
垿	axc	axc
埆	aqj	aqj
埇	aoe	aoe
埌	azm	azm
埏	aao	aao
埒	aau	aau
埘	adu	adu
埚	ajr	ajr
埝	arn	arn
埪	are	are
埫	adj	adj
埭	axi	axi
埯	aku	aku
埴	ani	ani
埼	akx	akx
埽	aoz	aoz
堉	atv	atv
堋	avv	avv
堌	agx	agx
堍	azz	azz
堎	aal	aal
堐	awv	awv
堙	aua	aua
堞	aus	aus
堠	amv	amv
堧	ahk	ahk
堨	adp	adp
堲	mca	mca
堼	vua	vua
堽	acb	acb
堾	aqd	aqd
塄	acy	acy
塅	aht	aht
塆	aqi	aqi
塍	vma	vma
塝	aky	aky
塥	aug	aug
塬	awh	awh
塱	zma	zma
墀	anf	anf
墁	aqm	aqm
墈	aoi	aoi
墉	axe	axe
墐	azt	azt
墒	akj	akj
墕	abx	abx
墘	auw	auw
墚	aos	aos
墡	aij	aij
墣	anz	anz
墦	aib	aib
墼	pga	pga
壅	pya	pya
壸	fen	fen
夐	qgl	qgl
夤	xlg	xlg
夬	akr	akr
夼	kgc	kgc
奁	kah	kah
奄	kud	kud
奓	kxx	kxx
奡	tkn	tkn
奭	kuu	kuu
妁	gfz	gfz
妊	gvw	gvw
妗	grw	grw
妘	gty	gty
妧	gtk	gtk
妩	gcu	gcu
妫	gzz	gzz
妭	gur	gur
姈	grl	grl
姞	gqj	gqj
姤	gwm	gwm
姮	geb	geb
姱	gke	gke
姶	ggh	ggh
姽	gqc	gqc
娀	gqu	gqu
娉	gge	gge
娓	gne	gne
娠	gzc	gzc
娩	gzk	gzk
娵	gfr	gfr
婀	gfx	gfx
婌	gir	gir
婍	gkx	gkx
婘	gmc	gmc
婞	gai	gai
婤	ggq	ggq
婪	cgn	cgn
婫	gdx	gdx
婳	geg	geg
婺	clg	clg
婻	gui	gui
婼	gbu	gbu
媂	gkz	gkz
媄	gik	gik
媆	ghk	ghk
媓	gnv	gnv
媖	gbk	gbk
媞	gdh	gdh
媪	gdc	gdc
媭	itg	itg
媱	gab	gab
媲	gsx	gsx
媵	vmg	vmg
媸	gjc	gjc
嫄	gwh	gwh
嫒	gir	gir
嫕	gan	gan
嫘	gby	gby
嫜	gsu	gsu
嫠	plg	plg
嫭	gxu	gxu
嫱	gad	gad
嫽	gkh	gkh
嬖	njg	njg
嬥	gnr	gnr
嬬	grh	grh
嬿	gux	gux
孅	gke	gke
孓	tzd	tzd
孛	fui	fui
孥	gru	gru
孪	qui	qui
孱	nuu	nuu
孳	syu	syu
宄	lmj	lmj
宕	lus	lus
宧	lec	lec
宬	liw	liw
寁	lxh	lxh
寤	lyj	lyj
寥	lni	lni
尜	hkh	hkh
尥	dfz	dfz
尨	uwi	uwi
尪	dvw	dvw
屃	nqb	nqb
屣	nkh	nkh
屦	nkg	nkg
屺	eaj	eaj
屼	elu	elu
屾	ees	ees
岈	eay	eay
岊	oes	oes
岍	eck	eck
岖	eah	eah
岘	eej	eej
岙	mes	mes
岜	eob	eob
岞	era	era
岠	eaa	eaa
岢	exk	exk
岣	esj	esj
岨	ekq	ekq
岵	exg	exg
岽	evh	evh
岿	epo	epo
峁	eym	eym
峂	elf	elf
峃	des	des
峄	erh	erh
峗	eqc	eqc
峘	eeb	eeb
峙	ews	ews
峛	exp	exp
峣	eql	eql
峧	efh	efh
峱	pwe	pwe
峿	evj	evj
崀	ezm	ezm
崁	ean	ean
崄	egd	egd
崌	enx	enx
崒	epu	epu
崚	eal	eal
崞	ecu	ecu
崟	etj	etj
崡	ewg	ewg
崤	ehv	ehv
崦	eku	eku
崧	eso	eso
崭	epl	epl
崶	evu	evu
崾	eug	eug
崿	ede	ede
嵁	eow	eow
嵅	eim	eim
嵎	ebr	ebr
嵖	esb	esb
嵚	etn	etn
嵝	edg	edg
嵫	esy	esy
嵬	ego	ego
嵯	eie	eie
嵲	eds	eds
嵴	efv	efv
嶂	esu	esu
嶅	qpe	qpe
嶍	enn	enn
嶒	evd	evd
嶓	eib	eib
嶝	eta	eta
嶟	ezu	ezu
嶦	eqi	eqi
嶲	erg	erg
巇	exq	exq
巉	ezz	ezz
巯	reg	reg
帏	zhw	zhw
帑	grz	grz
帔	zzp	zzp
帙	zam	zam
帡	zsc	zsc
帨	zvk	zvk
帱	zqu	zqu
帻	zne	zne
帼	zgl	zgl
幄	zng	zng
幖	zul	zul
幞	znz	znz
幪	zyr	zyr
庋	xur	xur
庑	xcu	xcu
庖	xfo	xfo
庠	xiy	xiy
庤	xws	xws
庱	xal	xal
庳	xgu	xgu
庼	xwt	xwt
廆	xgo	xgo
廑	xzt	xzt
廒	xql	xql
廙	xbt	xbt
廛	xma	xma
廨	xqf	xqf
弆	aob	aob
弇	gbc	gbc
弑	hse	hse
弢	ijr	ijr
弨	ima	ima
弶	ich	ich
弸	ivv	ivv
彀	fei	fei
彖	ors	ors
彗	qqo	qqo
彟	our	our
徂	kkq	kkq
徇	kfd	kfd
徉	kiy	kiy
徙	kjh	kjh
徛	kkx	kkx
徭	kab	kab
徼	knl	knl
忉	npd	npd
忐	inx	inx
忑	ehn	ehn
忝	mhx	mhx
忞	cnx	cnx
忡	nro	nro
忭	nph	nph
忮	nur	nur
忱	nck	nck
忳	nej	nej
忸	nwa	nwa
忺	nnq	nnq
怃	ncu	ncu
怅	nic	nic
怊	nma	nma
怍	nra	nra
怙	nxg	nxg
怩	nnw	nnw
怫	nin	nin
怿	nrh	nrh
恂	nfd	nfd
恓	nux	nux
恔	nfh	nfh
恙	inx	inx
恚	vnx	vnx
恝	qpn	qpn
恣	fnn	fnn
恧	hnx	hnx
恫	ngm	ngm
恸	nti	nti
恹	nwp	nwp
恽	ncp	ncp
悃	ngs	ngs
悆	kwn	kwn
悈	nqb	nqb
悒	njo	njo
悛	nol	nol
悝	nml	nml
悢	nzm	nzm
悫	fbn	fbn
悰	nll	nll
悴	npu	npu
悸	nwu	nwu
惆	ngq	ngq
惋	nlc	nlc
惎	onx	onx
惔	nxx	nxx
惙	nrr	nrr
惛	nyd	nyd
惝	ndj	ndj
惫	lbn	lbn
愃	nlb	nlb
愆	pon	pon
愍	bln	bln
愐	ntm	ntm
愔	nsy	nsy
愦	ncq	ncq
愫	nqy	nqy
愭	nad	nad
慆	nay	nay
慊	nsn	nsn
慝	abn	abn
慥	nfo	nfo
慬	nzt	nzt
慭	psn	psn
慵	nxe	nxe
憔	nrx	nrx
憕	nta	nta
憙	pjn	pjn
憩	fdn	fdn
憬	nxj	nxj
憭	nkh	nkh
憺	nqi	nqi
懊	nsk	nsk
懋	scn	scn
懔	npl	npl
戍	izd	izd
戛	tqg	tqg
戡	owq	owq
戣	tmq	tmq
戤	vrq	vrq
戥	dnq	dnq
戬	enq	enq
戭	leq	leq
戽	zld	zld
扂	zla	zla
扃	zgj	zgj
扅	zxx	zxx
扆	zyi	zyi
扊	zxx	zxx
扞	hkg	hkg
扪	hem	hem
扺	hyv	hyv
抃	hph	hph
抉	hak	hak
抔	hjb	hjb
抟	htz	htz
抨	hks	hks
拃	hra	hra
拊	hmu	hmu
拤	hih	hih
拯	hwe	hwe
拶	hgx	hgx
挓	hlv	hlv
挛	qhs	qhs
挝	huo	huo
挦	hou	hou
挹	hjo	hjo
捃	hoj	hoj
捭	hgu	hgu
捽	hpu	hpu
掇	hrr	hrr
掊	hkj	hkj
掎	hkx	hkx
掞	hxx	hxx
掭	hmh	hmh
掾	hor	hor
揄	hgp	hgp
揆	htm	htm
揕	how	how
揠	hag	hag
揳	hqk	hqk
揶	hff	hff
揿	htn	htn
搌	hny	hny
搐	hpb	hpb
搒	hky	hky
搛	hsn	hsn
搠	hsv	hsv
搦	hif	hif
搪	hxj	hxj
搴	lwh	lwh
摅	hxn	hxn
摏	hqy	hqy
摛	hpr	hpr
摭	hxx	hxx
摴	hre	hre
摽	hul	hul
撄	hqg	hqg
撖	hwl	hwl
撙	hzu	hzu
撺	hrr	hrr
擐	hcy	hcy
擘	njh	njh
擞	hdl	hdl
擿	hko	hko
攉	hrr	hrr
攽	tpl	tpl
敉	dlx	dlx
敔	vjl	vjl
敩	dul	dul
敫	nyl	nyl
斓	ces	ces
斝	dcl	dcl
斠	wgl	wgl
斫	ulj	ulj
斶	lcc	lcc
旃	ytp	ytp
旄	yte	yte
旆	ytc	ytc
旎	ytw	ytw
旐	ytf	ytf
旒	ytg	ytg
旞	yto	yto
旯	dmj	dmj
旰	dkg	dkg
旴	deu	deu
旵	des	des
旿	dtu	dtu
昃	dwk	dwk
昄	dwr	dwr
昈	dzh	dzh
昒	dfi	dfi
昡	dpy	dpy
昣	dki	dki
昤	drl	drl
昪	dob	dob
昫	dsj	dsj
昳	dam	dam
昺	der	der
昽	dzl	dzl
晅	deb	deb
晊	dgi	dgi
晐	dph	dph
晙	dol	dol
晢	hld	hld
晪	dyt	dyt
晫	dhu	dhu
晱	dxx	dxx
晷	dlj	dlj
暅	dnb	dnb
暌	dtm	dtm
暕	dps	dps
暲	dsu	dsu
暵	duk	duk
暶	dyh	dyh
暹	dro	dro
暾	dcl	dcl
暿	dpj	dpj
曌	dve	dve
曛	dxs	dxs
曩	dyw	dyw
曷	dfp	dfp
朏	vjg	vjg
朐	vsj	vsj
朓	vkf	vkf
朳	stb	stb
朸	sil	sil
杄	sxq	sxq
杌	slu	slu
杓	sfz	sfz
杕	skd	skd
杙	sqi	sqi
杞	saj	saj
杧	spw	spw
杩	srm	srm
杪	sha	sha
杲	dsm	dsm
杷	sob	sob
杻	swa	swa
枅	sck	sck
枇	sxb	sxb
枋	syf	syf
枍	ste	ste
枘	srn	srn
枥	swi	swi
枨	sic	sic
枲	ojs	ojs
枵	sje	sje
枸	ssj	ssj
枹	sfo	sfo
柁	slw	slw
柃	srl	srl
柈	ssh	ssh
柊	slf	slf
柖	sma	sma
柙	sgj	sgj
柝	slz	slz
柞	sra	sra
柢	syz	syz
柰	sls	sls
柷	sjk	sjk
柽	sra	sra
栀	swc	swc
栉	sbc	sbc
栌	shn	shn
栐	szi	szi
栒	sfd	sfd
栝	sfs	sfs
栟	ssc	ssc
栩	snv	snv
栴	stp	stp
栻	sqe	sqe
桁	spx	spx
桄	sdl	sdl
桅	sqc	sqc
桊	msm	msm
桕	syj	syj
桤	sea	sea
桧	skt	skt
桫	soa	soa
桯	sjv	sjv
桲	sfu	sfu
桴	sau	sau
桹	szm	szm
梃	svo	svo
梌	skw	skw
梠	sjj	sjj
梣	sew	sew
梴	sao	sao
梼	squ	squ
梽	san	san
梾	sps	sps
棁	svk	svk
棂	sox	sox
棐	psm	psm
棓	skj	skj
棤	sud	sud
棨	zls	zls
棪	sxx	sxx
棫	sqm	sqm
棬	smc	smc
棰	sxt	sxt
棻	bts	bts
棼	ctp	ctp
棽	crw	crw
椀	slc	slc
椁	scu	scu
椆	sgq	sgq
椋	sch	sch
椐	snx	snx
椑	sgu	sgu
椓	srz	srz
椠	pls	pls
椤	scx	scx
椪	ssn	ssn
椭	sfv	sfv
椸	syd	syd
楂	ssb	ssb
楒	sbn	sbn
楗	sxo	sxo
楙	scs	scs
楝	sps	sps
楦	slb	slb
楩	smp	smp
楪	sus	sus
楮	sae	sae
楯	swf	swf
榃	cbt	cbt
榅	sdc	sdc
榇	sks	sks
榍	snv	snv
榑	stu	stu
榔	szf	szf
榖	fes	fes
榰	sad	sad
榱	syt	syt
榷	scr	scr
槁	scg	scg
槃	lts	lts
槊	sjs	sjs
槔	snu	snu
槚	suq	suq
槜	srv	srv
槠	sia	sia
槭	sih	sih
槱	szx	szx
槲	sql	sql
樗	sre	sre
樘	sda	sda
橄	swl	swl
橇	see	see
橐	fus	fus
橑	skh	skh
橛	swn	swn
橞	stn	stn
橥	pas	pas
橦	skm	skm
檑	srb	srb
檗	njs	njs
檞	sqf	sqf
檠	bss	bss
檩	spl	spl
櫆	sgl	sgl
欂	squ	squ
欤	ewn	ewn
欹	kxn	kxn
欻	xxn	xxn
歅	uan	uan
歙	gnn	gnn
殂	xkq	xkq
殄	xki	xki
殍	xau	xau
殓	xgd	xgd
殛	xte	xte
殣	xzt	xzt
殪	xfa	xfa
毂	fpc	fpc
毌	ngg	ngg
毖	xna	xna
毪	eof	eof
毵	oke	oke
毹	gve	gve
氅	dje	dje
氆	esd	esd
氇	ezd	ezd
氍	ffe	ffe
氕	tap	tap
氖	tvn	tvn
氙	tes	tes
氚	tgc	tgc
氡	tlf	tlf
氤	tgk	tgk
氩	ten	ten
氲	tdc	tdc
氾	ocj	ocj
氿	omj	omj
汈	owe	owe
汊	orz	orz
汋	ofz	ofz
汔	otw	otw
汜	oos	oos
汧	ock	ock
汨	odr	odr
汩	odr	odr
汫	owj	owj
汭	orn	orn
沄	oty	oty
沇	ook	ook
沔	oew	oew
沘	oxb	oxb
沚	oji	oji
沨	obh	obh
沮	okq	okq
沺	obt	obt
泂	ogj	ogj
泃	osj	osj
泅	ogk	ogk
泇	oij	oij
泐	ofi	ofi
泖	oym	oym
泙	oks	oks
泚	ojw	ojw
泜	oyz	oyz
泞	olr	olr
泺	oyh	oyh
洄	odh	odh
洈	oqc	oqc
洌	oxp	oxp
洎	odi	odi
洑	omp	omp
洓	onb	onb
洘	oae	oae
洚	ola	ola
洢	oma	oma
洣	odm	odm
洧	ouv	ouv
洨	ofh	ofh
洫	oac	oac
洭	oav	oav
洮	okf	okf
洳	ogj	ogj
洴	osc	osc
洸	odl	odl
洿	oke	oke
浃	oms	oms
浈	ohq	ohq
浉	opz	opz
浍	okt	okt
浐	okw	okw
浕	onf	onf
浛	orj	orj
浞	oeu	oeu
浟	oml	oml
浠	ohz	ohz
浡	ofu	ofu
浥	ojo	ojo
浬	oml	oml
浭	opg	opg
浯	ovj	ovj
浰	owp	owp
浲	olq	olq
浼	ozk	ozk
涄	oge	oge
涍	oau	oau
涑	ops	ops
涔	oew	oew
涘	oov	oov
涞	ops	ops
涢	ojq	ojq
涫	old	old
涴	olc	olc
淆	ohv	ohv
淏	odm	odm
淖	ohu	ohu
淙	oll	oll
淜	ovv	ovv
淝	ovo	ovo
淟	oyt	oyt
淠	obl	obl
淬	opu	opu
淯	otv	otv
淴	ofn	ofn
渌	ooi	ooi
渑	oju	oju
渟	ocr	ocr
渫	ous	ous
渰	ogb	ogb
渲	olb	olb
渼	oik	oik
湃	ohq	ohq
湑	ohv	ohv
湓	otc	otc
湔	osp	osp
湝	oxn	oxn
湟	onv	onv
湣	obd	obd
湫	owx	owx
湲	oar	oar
湴	osn	osn
溁	oys	oys
溇	odg	odg
溉	omc	omc
溍	oed	oed
溘	oac	oac
溚	obg	obg
溞	orc	orc
溠	oie	oie
溦	oel	oel
溱	oqw	oqw
溲	oyr	oyr
溵	owt	owt
溷	ogr	ogr
溹	ofy	ofy
溻	odn	odn
溽	ozu	ozu
滂	oky	oky
滃	otn	otn
滆	oug	oug
滉	odl	odl
滍	ojc	ojc
滏	ott	ott
滓	olf	olf
滔	oay	oay
滗	oke	oke
滠	ofr	ofr
滦	oqs	oqs
滧	ofl	ofl
滪	oct	oct
滫	omv	omv
滹	oxu	oxu
漈	otl	otl
漉	oal	oal
漋	ofn	ofn
漖	oal	oal
漤	ocg	ocg
漦	pli	pli
漭	obb	obb
漴	oel	oel
漶	orn	orn
漷	ocf	ocf
漹	obx	obx
漻	oni	oni
漼	oer	oer
潆	oyy	oyy
潍	oyr	oyr
潏	ocj	ocj
潖	ovo	ovo
潟	oyx	oyx
潢	oug	oug
潦	okh	okh
潩	obt	obt
潲	owv	owv
潵	oul	oul
潽	osd	osd
潾	oda	oda
澂	oel	oel
澉	owl	owl
澌	ool	ool
澛	ozd	ozd
澥	oqf	oqf
澧	oya	oya
澪	orr	orr
澭	opr	opr
澴	ocy	ocy
澶	opb	opb
澼	onf	onf
澽	oxr	oxr
濉	ofr	ofr
濋	och	och
濞	odl	odl
濩	obr	obr
瀌	oax	oax
瀍	oxa	oxa
瀔	oft	oft
瀱	ocp	ocp
瀵	odt	odt
瀹	ogy	ogy
瀼	oyw	oyw
灈	ofr	ofr
炌	xkn	xkn
炘	xlj	xlj
炟	xbd	xbd
炣	xxk	xxk
炱	ojx	ojx
炻	xus	xus
烀	xau	xau
烃	xre	xre
烊	xiy	xiy
烔	xgm	xgm
烜	xeb	xeb
烝	wix	wix
烠	xuv	xuv
烶	xvo	xvo
烺	xzm	xzm
烻	xao	xao
焆	xjv	xjv
焌	xol	xol
焓	xrj	xrj
焘	qux	qux
焜	xdx	xdx
焞	xcu	xcu
煁	xow	xow
煃	xkv	xkv
煅	xht	xht
煊	xlb	xlb
煋	xdn	xdn
煓	xeh	xeh
煟	xbv	xbv
煳	xxv	xxv
煴	xdc	xdc
煺	xmo	xmo
熇	xcg	xcg
熛	xul	xul
熜	xsn	xsn
熥	xoo	xoo
熻	xgn	xgn
燋	xrx	xrx
燏	xcj	xcj
燚	xxx	xxx
燠	xsk	xsk
燧	xso	xso
燹	rrx	rrx
爇	bax	bax
爔	xiq	xiq
爚	xgy	xgy
爝	xau	xau
爟	xbr	xbr
牁	yxk	yxk
牂	yiy	yiy
牖	yzt	yzt
牚	dja	dja
牝	fwb	fwb
牤	fpw	fpw
牥	fyf	fyf
牮	mqf	mqf
牺	fux	fux
牻	fui	fui
牾	fvj	fvj
牿	ffj	ffj
犄	fkx	fkx
犋	fkt	fkt
犏	fzy	fzy
犨	rrf	rrf
犰	pmj	pmj
犴	pkg	pkg
犷	pxg	pxg
狁	pok	pok
狃	pwa	pwa
狉	pje	pje
狎	pgj	pgj
狒	pin	pin
狝	pqh	pqh
狞	plr	plr
狩	plu	plu
狯	pkt	pkt
狰	pqx	pqx
狳	pkw	pkw
狴	pxa	pxa
狺	piy	piy
狻	pol	pol
猁	pwp	pwp
猃	pgd	pgd
猄	pch	pch
猇	pxb	pxb
猊	pyk	pyk
猕	pih	pih
猖	pdd	pdd
猗	pkx	pkx
猞	pkf	pkf
猬	pbv	pbv
猯	peh	peh
猰	pqk	pqk
猱	pcs	pcs
猷	zpq	zpq
猺	pab	pab
獍	psk	psk
獐	psu	psu
獗	pwn	pwn
獠	pkh	pkh
獬	pqf	pqf
獯	pxs	pxs
玃	pfr	pfr
玎	vrd	vrd
玒	veg	veg
玓	vfz	vfz
玕	vkg	vkg
玙	vee	vee
玞	vmf	vmf
玠	vkn	vkn
玡	vay	vay
玢	vtp	vtp
玤	vqf	vqf
玭	vxb	vxb
玱	vkc	vkc
玳	vmq	vmq
玶	vks	vks
玷	vla	vla
玼	vjw	vjw
玿	vma	vma
珅	vds	vds
珇	vkq	vkq
珋	vym	vym
珌	vna	vna
珏	vlv	vlv
珐	vao	vao
珒	vxv	vxv
珕	vii	vii
珖	vdl	vdl
珙	vut	vut
珛	vuv	vuv
珝	vnv	vnv
珢	vmg	vmg
珣	vfd	vfd
珥	vfe	vfe
珦	vsj	vsj
珧	vkf	vkf
珩	vpx	vpx
珪	vvg	vvg
珫	vtk	vtk
珲	vcp	vcp
珵	vjv	vjv
珷	vej	vej
珸	vvj	vvj
珹	viw	viw
珽	vvo	vvo
琀	vrj	vrj
琄	vjv	vjv
琈	vau	vau
琊	vaf	vaf
琎	vwo	vwo
琔	vlh	vlh
琚	vnx	vnx
琟	vru	vru
琡	vir	vir
琤	vqx	vqx
琫	vqh	vqh
琬	vlc	vlc
琭	voi	voi
琮	vll	vll
琲	vpf	vpf
瑀	var	var
瑁	vdf	vdf
瑂	vnf	vnf
瑃	vqd	vqd
瑅	vdh	vdh
瑆	vdn	vdn
瑑	vor	vor
瑓	vps	vps
瑔	vni	vni
瑖	vht	vht
瑚	vxv	vxv
瑝	vnv	vnv
瑢	vlc	vlc
瑧	vqw	vqw
瑨	ved	ved
瑬	otl	otl
瑭	vxj	vxj
瑱	vnt	vnt
瑳	vie	vie
璀	ver	ver
璁	vsn	vsn
璆	vni	vni
璈	vql	vql
璋	vsu	vsu
璎	vqg	vqg
璒	vta	vta
璘	vda	vda
璠	vib	vib
璥	vbl	vbl
璩	vxr	vxr
璪	vjs	vjs
璬	vnl	vnl
璮	vpb	vpb
璱	vva	vva
璲	vso	vso
璺	ygl	ygl
瓀	vrh	vrh
瓒	vfq	vfq
瓖	vyw	vyw
瓘	vbr	vbr
瓞	aam	aam
瓠	kea	kea
瓻	hum	hum
瓿	kjm	kjm
甍	bcm	bcm
甏	pim	pim
甓	njm	njm
甗	xum	xum
甡	nns	nns
甥	nbi	nbi
甦	pns	pns
甾	gbt	gbt
畈	bwr	bwr
畋	blx	blx
畎	bpq	bpq
畖	bag	bag
畚	okb	okb
畛	bki	bki
畤	bws	bws
畦	bvg	bvg
畬	kwb	kwb
畯	bol	bol
畲	klb	klb
畹	blc	blc
疁	bni	bni
疃	bkm	bkm
疍	hbd	hbd
疐	fbh	fbh
疔	urd	urd
疠	uep	uep
疡	uwi	uwi
疢	uxh	uxh
疥	ukn	ukn
疬	uwi	uwi
疭	ukk	ukk
疰	uzv	uzv
疳	uyg	uyg
疴	uxk	uxk
痃	upy	upy
痄	ura	ura
痈	uey	uey
痉	ure	ure
痊	ukv	ukv
痍	uki	uki
痓	ugi	ugi
痤	uka	uka
痦	uvj	uvj
痪	uqk	uqk
痫	ues	ues
痱	upf	upf
痼	ugx	ugx
瘁	upu	upu
瘃	urz	urz
瘅	uvu	uvu
瘌	upp	upp
瘕	unr	unr
瘗	uma	uma
瘙	urc	urc
瘛	uqn	uqn
瘥	uie	uie
瘭	uul	uul
瘰	uby	uby
瘳	uni	uni
瘵	utl	utl
瘼	ulm	ulm
瘿	uqg	uqg
癀	uug	uug
癃	ufn	ufn
癍	uvv	uvv
癔	usn	usn
癗	urb	urb
癯	ufr	ufr
皈	nwr	nwr
皑	nea	nea
皕	uub	uub
皛	nnn	nnn
皞	nnu	nnu
皤	nib	nib
皦	nnl	nnl
皭	nau	nau
皲	cpz	cpz
盉	wcm	wcm
盍	aoc	aoc
盥	yic	yic
盦	rwc	rwc
盷	fff	fff
眄	few	few
眇	fha	fha
眊	fem	fem
眍	fah	fah
眚	nfm	nfm
眢	xcf	xcf
眬	fzl	fzl
眵	fxx	fxx
睃	fol	fol
睄	fdv	fdv
睎	fhz	fhz
睢	fru	fru
瞀	clf	clf
瞌	fac	fac
瞍	fyr	fyr
瞢	bcf	bcf
瞩	fnr	fnr
瞫	fuu	fuu
瞵	fda	fda
瞽	puf	puf
矞	cgj	cgj
矧	vic	vic
矰	vvd	vvd
矸	ukg	ukg
矻	utw	utw
矼	ueg	ueg
矾	ubz	ubz
砄	uak	uak
砆	umf	umf
砉	qus	qus
砑	uay	uay
砒	uxb	uxb
砘	uej	uej
砜	ubh	ubh
砝	uao	uao
砟	ura	ura
砠	ukq	ukq
砧	ula	ula
砫	uzv	uzv
砬	ukl	ukl
砮	gru	gru
砵	use	use
砹	ubh	ubh
砻	zus	zus
砼	uke	uke
砾	uyh	uyh
础	ujg	ujg
硁	ure	ure
硇	ush	ush
硊	uqc	uqc
硍	umg	umg
硎	ucp	ucp
硔	uut	uut
硖	ums	ums
硗	uql	uql
硙	uea	uea
硭	ubp	ubp
硿	ure	ure
碃	uqv	uqv
碈	uyd	uyd
碏	uud	uud
碡	uqn	uqn
碥	uzy	uzy
碨	uby	uby
碲	ukz	ukz
碶	uqk	uqk
碹	ulb	ulb
磉	urs	urs
磏	usn	usn
磔	uxs	uxs
磙	uyo	uyo
磜	utl	utl
磬	anu	anu
磴	uta	uta
磹	uuu	uuu
磻	uib	uib
礅	ucl	ucl
礌	urb	urb
礓	uee	uee
礞	uyr	uyr
礴	uqu	uqu
礵	urf	urf
祀	los	los
祃	lrm	lrm
祆	lmt	lmt
祊	lyf	lyf
祋	lts	lts
祏	lus	lus
祓	lur	lur
祚	lra	lra
祧	lkf	lkf
祲	lor	lor
祾	lal	lal
禊	lqk	lqk
禋	lua	lua
禒	lor	lor
禔	ldh	ldh
禘	lkz	lkz
禚	lix	lix
禛	lnt	lnt
禤	lcn	lcn
禳	lyw	lyw
禺	brn	brn
秕	wxb	wxb
秣	wpm	wpm
秫	wsz	wsz
秬	waa	waa
秭	wqk	wqk
秸	wqj	wqj
稂	wzm	wzm
稃	wau	wau
稆	wjj	wjj
稌	wkw	wkw
稑	waa	waa
稙	wni	wni
稣	zwh	zwh
稷	wbl	wbl
穄	wtl	wtl
穑	wad	wad
穙	wnz	wnz
穜	wkm	wkm
穟	wso	wso
穰	wyw	wyw
穸	rxx	rxx
穹	rig	rig
窀	rej	rej
窅	rfm	rfm
窈	ryi	ryi
窊	rag	rag
窎	rzn	rzn
窒	rgi	rgi
窕	rkf	rkf
窠	rbs	rbs
窣	rpu	rpu
窨	rsy	rsy
窬	rgp	rgp
窭	rdg	rdg
窳	raa	raa
竑	kuo	kuo
竘	ksj	ksj
竣	kol	kol
竦	kps	kps
竫	kqx	kqx
竺	kte	kte
竽	keu	keu
笄	kck	kck
笆	kob	kob
笊	kau	kau
笞	koj	koj
笥	kwm	kwm
笪	kbd	kbd
笮	kra	kra
笯	kgr	kgr
笱	ksj	ksj
笸	kaj	kaj
笾	kio	kio
筀	kvg	kvg
筅	kfk	kfk
筇	kef	kef
筌	kkv	kkv
筘	khj	khj
筚	kxu	kxu
筢	kho	kho
筤	kzm	kzm
筥	kjj	kjj
筦	klk	klk
筮	kek	kek
筲	kdv	kdv
筵	kao	kao
筶	kfj	kfj
筻	kpg	kpg
箅	kbl	kbl
箐	kqv	kqv
箓	koi	koi
箖	kcl	kcl
箜	kre	kre
箢	klc	klc
箦	kne	kne
箨	khh	khh
箪	kvu	kvu
箴	kim	kim
篁	knv	knv
篌	kmv	kmv
篙	kcg	kcg
篚	kap	kap
篝	kwa	kwa
篥	kus	kus
篦	ksx	ksx
篪	kwb	kwb
篯	ktq	ktq
篼	knk	knk
篾	kcz	kcz
簃	kwx	kwx
簉	kfo	kfo
簏	kal	kal
簕	kzi	kzi
簖	kdl	kdl
簝	kkh	kkh
簟	kuu	kuu
簠	ktc	ktc
簰	kyu	kyu
簸	koz	koz
籀	khb	khb
籥	kgy	kgy
籴	kdm	kdm
籼	des	des
粜	jgd	jgd
粝	dwp	dwp
粞	dux	dux
粳	dpg	dpg
糇	dmv	dmv
糈	dhv	dhv
糌	dld	dld
糒	due	due
糵	bad	bad
絜	qpy	qpy
絷	hmy	hmy
綮	zly	zly
縠	fey	fey
縢	vmy	vmy
縻	xcy	xcy
繄	avy	avy
繇	aby	aby
纂	kfy	kfy
纛	qny	qny
纡	yeu	yeu
纥	ytw	ytw
纩	yxg	yxg
纫	ypz	ypz
纭	yty	yty
纴	yvw	yvw
纻	yle	yle
纼	yic	yic
绁	yuw	yuw
绂	yur	yur
绉	yqo	yqo
绋	yin	yin
绎	yrh	yrh
绐	yoj	yoj
绖	ygi	ygi
绠	ypg	ypg
绡	ydv	ydv
绤	ycg	ycg
绨	ysq	ysq
绱	ydj	ydj
绲	ydx	ydx
绶	yir	yir
绹	yfb	yfb
缂	yzg	yzg
缃	ysf	ysf
缄	yim	yim
缊	ydc	ydc
缌	ybn	ybn
缐	yni	yni
缑	ymv	ymv
缒	yao	yao
缗	ybd	ybd
缜	ynt	ynt
缞	yyt	yyt
缟	ycg	ycg
缡	ypr	ypr
缢	ysc	ysc
缣	ysn	ysn
缥	yul	yul
缧	yby	yby
缫	ygs	ygs
缬	yqt	yqt
缯	yvd	yvd
缲	yjs	yjs
缵	yfq	yfq
罅	bxu	bxu
罍	bbb	bbb
罟	cxg	cxg
罨	cku	cku
罱	cui	cui
罴	cax	cax
罶	cyb	cyb
罽	cwp	cwp
罾	cvd	cvd
羑	iqz	iqz
羓	iob	iob
羕	izi	izi
羖	its	its
羝	iyz	iyz
羰	iex	iex
羱	iwh	iwh
羼	nii	nii
翂	ntp	ntp
翃	uon	uon
翈	gnv	gnv
翙	exn	exn
翚	ncp	ncp
翛	mln	mln
翥	anv	anv
翦	svn	svn
翯	ncg	ncg
翱	nkn	nkn
翳	avn	avn
翷	dxn	dxn
翾	cmn	cmn
耆	awd	awd
耇	asj	asj
耏	his	his
耑	ehe	ehe
耔	tsu	tsu
耖	tsa	tsa
耘	tst	tst
耜	tsd	tsd
耠	tsg	tsg
耢	tsi	tsi
耤	tsd	tsd
耥	tsj	tsj
耩	tsa	tsa
耰	tsl	tsl
耱	tsu	tsu
耵	frd	frd
聃	fga	fga
聍	flr	flr
聒	ffs	ffs
聩	fcq	fcq
聱	qpf	qpf
肟	vee	vee
肪	vyf	vyf
肫	vej	vej
肭	vrn	vrn
肮	vpb	vpb
肷	vnq	vnq
肸	vtu	vtu
肼	vwj	vwj
胁	vit	vit
胂	vds	vds
胄	gvy	gvy
胈	vur	vur
胙	vra	vra
胝	vyz	vyz
胠	vao	vao
胣	vtd	vtd
胨	vvh	vvh
胪	vhn	vhn
胭	vgk	vgk
胲	vph	vph
胼	vsc	vsc
脍	vkt	vkt
脎	vhs	vhs
脒	vdm	vdm
脔	qrk	qrk
脟	vau	vau
脩	mlv	mlv
脬	vau	vau
脲	vni	vni
脶	vjr	vjr
脿	vqy	vqy
腈	vqv	vqv
腒	vnx	vnx
腘	vgl	vgl
腠	vqm	vqm
腧	vgp	vgp
腨	veh	veh
腯	vwf	vwf
腴	vyk	vyk
腼	vtm	vtm
腽	vdc	vdc
膂	ytv	ytv
膊	vtu	vtu
膑	vlt	vlt
膙	vic	vic
膦	vda	vda
臃	vpr	vpr
臌	vpr	vpr
臑	vrh	vrh
臜	vfq	vfq
臬	dsm	dsm
臾	ykr	ykr
舁	ybc	ybc
舄	yfx	yfx
舠	lpd	lpd
舢	les	les
舣	lzh	lzh
舥	lob	lob
舫	lyf	lyf
舭	lxb	lxb
舯	lro	lro
舲	lrl	lrl
舳	lgy	lgy
舴	lra	lra
舸	lxk	lxk
舻	lhn	lhn
舾	lux	lux
艄	ldv	ldv
艅	lkw	lkw
艉	lne	lne
艎	lnv	lnv
艚	lyd	lyd
艟	lkm	lkm
艨	lyr	lyr
艴	ino	ino
艽	bmj	bmj
芄	bmz	bmz
芏	bat	bat
芑	baj	baj
芘	bxb	bxb
芟	bts	bts
芠	bcw	bcw
芤	buw	buw
芪	byv	byv
芰	bur	bur
芴	bfi	bfi
芼	bem	bem
芾	bnc	bnc
苁	bkk	bkk
苄	bph	bph
苈	bwi	bwi
苉	bak	bak
苊	bwc	bwc
苌	bic	bic
苎	ble	ble
苒	bga	bga
苘	bgj	bgj
苠	bbm	bbm
苤	bje	bje
苧	blr	blr
苫	bla	bla
苴	bkq	bkq
苻	bmu	bmu
苾	bna	bna
茀	bin	bin
茁	bjg	bjg
茆	bym	bym
茈	bjw	bjw
茋	byz	byz
茌	bma	bma
茏	bzl	bzl
茓	brx	brx
茔	yat	yat
茛	bmg	bmg
茝	bec	bec
茭	bfh	bfh
茯	bmp	bmp
茳	qeg	qeg
茺	btk	btk
茽	bmr	bmr
荁	beb	beb
荄	bph	bph
荏	bmv	bmv
荑	bki	bki
荓	bsc	bsc
荖	baw	baw
荙	bko	bko
荛	bql	bql
荥	yis	yis
荦	yfn	yfn
荨	bou	bou
荩	bnf	bnf
荬	bwk	bwk
荭	bye	bye
荮	byu	byu
荸	bfu	bfu
莅	bmk	bmk
莙	boj	boj
莛	bvo	bvo
莝	bka	bka
莨	bzm	bzm
莩	bau	bau
莶	bgd	bgd
莸	bpd	bpd
莿	bnp	bnp
菉	boi	boi
菍	brn	brn
菏	qxk	qxk
菔	bvr	bvr
菘	bso	bso
菝	bhr	bhr
菟	bzz	bzz
菠	qzp	qzp
菥	bsl	bsl
菪	blu	blu
菰	bua	bua
菹	qkq	qkq
菼	bxx	bxx
菽	bir	bir
萆	bgu	bgu
萏	bqy	bqy
萑	bru	bru
萘	bkl	bkl
萚	bhh	bhh
萜	bzl	bzl
萣	blh	blh
萩	bwx	bwx
萳	bui	bui
萹	bzy	bzy
葎	bkx	bkx
葑	bvu	bvu
葖	brp	brp
葙	bsf	bsf
葚	bow	bow
葜	bqk	bqk
葫	bxv	bxv
葰	bml	bml
葳	big	big
葴	bim	bim
葶	bcr	bcr
葸	bbn	bbn
蒄	bcu	bcu
蒇	biq	biq
蒈	bxn	bxn
蒉	bcq	bcq
蒌	bdg	bdg
蒎	qwy	qwy
蒟	bks	bks
蒨	bmv	bmv
蒯	bvp	bvp
蒱	bht	bht
蒴	bsv	bsv
蒻	bif	bif
蓁	bqw	bqw
蓂	ydf	ydf
蓇	bdg	bdg
蓊	btn	btn
蓍	bad	bad
蓏	baa	baa
蓐	bzu	bzu
蓟	bzp	bzp
蓠	bpr	bpr
蓢	bzv	bzv
蓣	bct	bct
蓥	ytj	ytj
蓰	bkh	bkh
蔀	bkf	bkf
蔃	bic	bic
蔈	bul	bul
蔊	bxk	bxk
蔌	bpn	bpn
蔟	byv	byv
蔸	bnk	bnk
蔹	bgl	bgl
蔺	ber	ber
蕈	buu	buu
蕗	beo	beo
蕞	bdr	bdr
蕤	brn	brn
蕰	boc	boc
蕹	bpr	bpr
蕺	bjq	bjq
蕻	bit	bit
薁	bsk	bsk
薢	bqf	bqf
薤	bxe	bxe
薨	bcw	bcw
薮	bdl	bdl
薳	bao	bao
薷	brh	brh
薸	bol	bol
薹	bqg	bqg
薿	bwh	bwh
藁	bcs	bcs
藟	bbb	bbb
藠	bnn	bnn
藦	bxh	bxh
藨	bax	bax
蘅	bpk	bpk
蘘	byw	byw
蘧	bxo	bxo
蘩	bty	bty
虒	wxb	wxb
虓	mxb	mxb
虢	aub	aub
虤	xbb	xbb
虬	cwe	cwe
虮	cbj	cbj
虷	ckg	ckg
虸	cui	cui
虺	lcc	lcc
虼	ctw	ctw
虿	epc	epc
蚄	cyf	cyf
蚆	cob	cob
蚋	crn	crn
蚍	cxb	cxb
蚓	cic	cic
蚣	cto	cto
蚧	ckn	ckn
蚨	cmf	cmf
蚪	cld	cld
蚯	cle	cle
蚱	cra	cra
蚲	cks	cks
蛃	cer	cer
蛉	crl	crl
蛏	cra	cra
蛐	cyq	cyq
蛑	cof	cof
蛔	cdh	cdh
蛘	ciy	ciy
蛞	cfs	cfs
蛩	ebc	ebc
蛲	cql	cql
蛴	ccn	ccn
蛸	cdv	cdv
蜉	cau	cau
蜊	cwp	cwp
蜎	cjv	cjv
蜐	cai	cai
蜓	cvo	cvo
蜘	cvj	cvj
蜞	coq	coq
蜢	cuc	cuc
蜣	ciw	ciw
蜩	cgq	cgq
蜮	cqm	cqm
蜴	cdi	cdi
蜻	cqv	cqv
蜾	cbs	cbs
蜿	clc	clc
蝌	cwl	cwl
蝓	cgp	cgp
蝘	cag	cag
蝙	czy	czy
蝣	cyu	cyu
蝤	czq	czq
蝥	clc	clc
蝮	ctl	ctl
蝲	cpp	cpp
蝴	cxv	cxv
蝻	cui	cui
蝽	cqd	cqd
蝾	cys	cys
螂	czf	czf
螅	cdn	cdn
螋	cyr	cyr
螗	cxj	cxj
螟	ccf	ccf
螠	csc	csc
螣	vmc	vmc
螫	anc	anc
螬	cyd	cyd
螭	cpr	cpr
螯	qpc	qpc
螱	nlc	nlc
螵	cul	cul
螽	lfc	lfc
蟆	clm	clm
蟊	ccc	ccc
蟋	cin	cin
蟏	cbt	cbt
蟛	cpi	cpi
蟪	ctn	ctn
蟫	cuu	cuu
蟮	cij	cij
蠊	cxn	cxn
蠋	ccc	ccc
蠓	cyr	cyr
蠕	crh	crh
蠖	cbr	cbr
蠲	stc	stc
蠹	fuc	fuc
蠼	cfr	cfr
衃	acj	acj
衄	aca	aca
衎	kkk	kkk
衒	kpk	kpk
衠	knk	knk
衲	lrn	lrn
袈	ijy	ijy
袗	lki	lki
袢	lsh	lsh
袤	ycm	ycm
袯	ljr	ljr
袱	lmp	lmp
袷	lgh	lgh
袼	log	log
裈	lcp	lcp
裉	lmg	lmg
裎	ljv	ljv
裒	yyj	yyj
裛	yjo	yjo
裟	ohy	ohy
裣	lgd	lgd
裥	led	led
裰	lrr	lrr
裼	ldi	ldi
褊	lzy	lzy
褓	lms	lms
褕	lgp	lgp
褟	ldn	ldn
褫	lwb	lwb
褯	lxz	lxz
褰	lwy	lwy
襁	lic	lic
襕	les	les
襚	lso	lso
襜	lqi	lqi
襞	njy	njy
襫	lku	lku
襻	lch	lch
觃	eui	eui
觇	lej	lej
觊	eae	eae
觋	eke	eke
觌	uwe	uwe
觎	gve	gve
觏	wge	wge
觖	qak	qak
觚	qag	qag
觞	qti	qti
觟	qvg	qvg
觫	qps	qps
觭	qkx	qkx
觯	qvu	qvu
觱	imq	imq
觳	feq	feq
觿	qej	qej
訄	miy	miy
訚	eiy	eiy
訾	jwi	jwi
詈	ciy	ciy
詟	ziy	ziy
謇	lwi	lwi
譬	nji	nji
讣	ihb	ihb
讦	ikg	ikg
讧	ieg	ieg
讫	itw	itw
讱	ipz	ipz
讵	iaa	iaa
讶	iay	iay
讻	ihg	ihg
诇	igj	igj
诋	iyz	iyz
诎	ijg	ijg
诐	izp	izp
诔	its	its
诖	ivg	ivg
诜	ifk	ifk
诟	iwm	iwm
诠	ikv	ikv
诣	iwd	iwd
诨	icp	icp
诩	inv	inv
诮	idv	idv
诰	ifj	ifj
诹	ifr	ifr
诼	irz	irz
诿	iwg	iwg
谄	iqy	iqy
谆	icu	icu
谇	ipu	ipu
谌	iow	iow
谑	ixo	ixo
谖	iar	iar
谞	ihv	ihv
谩	iqm	iqm
谪	ikx	ikx
谫	isp	isp
谮	icd	icd
谯	irx	irx
谰	ies	ies
谳	iup	iup
谵	iqi	iqi
谼	cut	cut
谿	ayc	ayc
豌	alc	alc
豕	rss	rss
豨	rhz	rhz
豮	ruq	ruq
豸	pii	pii
貅	pms	pms
貆	peb	peb
貊	pub	pub
貔	psx	psx
贳	uwq	uwq
贶	qjk	qjk
贽	hmq	hmq
赀	jwq	jwq
赁	mvq	mvq
赂	qog	qog
赅	qph	qph
赆	qnf	qnf
赇	qiq	qiq
赈	qzc	qzc
赉	psq	psq
赒	qgq	qgq
赓	xoq	xoq
赕	qxx	qxx
赗	qdf	qdf
赙	qtu	qtu
赜	ene	ene
赝	wmq	wmq
赡	qqi	qqi
赧	anr	anr
赪	anq	anq
赳	dcj	dcj
趑	dfn	dfn
趯	dnr	dnr
趱	dfq	dfq
趵	efz	efz
趼	eck	eck
趿	erj	erj
跂	eur	eur
跆	eoj	eoj
跏	eij	eij
跗	emu	emu
跞	eyh	eyh
跣	efk	efk
跱	ews	ews
跸	exu	exu
跻	ecn	ecn
跽	ean	ean
踊	eoe	eoe
踌	equ	equ
踒	ewg	ewg
踔	ehu	ehu
踣	ekj	ekj
踦	ekx	ekx
踬	ewq	ewq
踶	edh	edh
踺	exo	exo
踽	ear	ear
蹀	eus	eus
蹂	ecs	ecs
蹅	esb	esb
蹈	eay	eay
蹐	efv	efv
蹑	efr	efr
蹜	elu	elu
蹢	ekx	ekx
蹯	eib	eib
蹶	ewn	ewn
蹽	ekh	ekh
蹾	ecl	ecl
躇	eba	eba
躏	ebr	ebr
躐	egy	egy
躔	exa	exa
躜	efq	efq
躞	eir	eir
轪	pkd	pkd
轫	ppz	ppz
轱	pxg	pxg
轲	pxk	pxk
轵	pjt	pjt
轷	pau	pau
轸	pki	pki
轹	pyh	pyh
轺	pma	pma
轾	pgi	pgi
辀	plo	plo
辁	pkv	pkv
辂	pog	pog
辇	mmp	mmp
辊	pdx	pdx
辋	pgp	pgp
辌	pch	pch
辎	pgb	pgb
辏	pqm	pqm
辒	pdc	pdc
辚	pda	pda
辿	eod	eod
迄	two	two
迓	aod	aod
迕	tuo	tuo
迨	ojo	ojo
迮	rod	rod
迳	reo	reo
迺	uod	uod
逅	wmo	wmo
逋	tod	tod
逖	pxo	pxo
逡	oto	oto
逦	evo	evo
逭	ldo	ldo
逯	oio	oio
逴	hdo	hdo
逵	ato	ato
逻	cxo	cxo
遄	eho	eho
遆	kzo	kzo
遘	wgo	wgo
遨	qpo	qpo
遴	dxo	dxo
遹	cgo	cgo
遽	xro	xro
邂	qpo	qpo
邃	rso	rso
邗	kfe	kfe
邘	euf	euf
邙	pfe	pfe
邠	tpf	tpf
邡	yfe	yfe
邬	zfe	zfe
邯	yfe	yfe
邲	naf	naf
邴	erf	erf
邶	ywf	ywf
邺	nfe	nfe
邽	vfe	vfe
邾	apf	apf
邿	wfe	wfe
郃	gfe	gfe
郄	huf	huf
郇	fdf	fdf
郈	wmf	wmf
郏	msf	msf
郐	ktf	ktf
郓	cpf	cpf
郗	huf	huf
郚	vjf	vjf
郛	auf	auf
郢	jvf	jvf
郤	cfe	cfe
郦	evf	evf
郧	jqf	jqf
郪	xgf	xgf
郫	guf	guf
郯	xxf	xxf
郴	cfe	cfe
郸	vuf	vuf
郾	adf	adf
郿	nff	nff
鄀	buf	buf
鄃	gvf	gvf
鄄	uaf	uaf
鄅	ajf	ajf
鄌	xxf	xxf
鄑	enf	enf
鄗	cfe	cfe
鄘	xxf	xxf
鄚	lfe	lfe
鄜	afe	afe
鄠	ref	ref
鄫	vdf	vdf
鄯	isf	isf
鄹	frf	frf
酂	fkf	fkf
酃	rdf	rdf
酅	erf	erf
酆	eqf	eqf
酋	zqq	zqq
酎	zuc	zuc
酏	zdy	zdy
酗	zhg	zhg
酝	zty	zty
酞	zkz	zkz
酡	zlw	zlw
酤	zxg	zxg
酦	zjr	zjr
酲	zjv	zjv
酴	zkw	zkw
酹	zau	zau
酺	ztf	ztf
酽	zew	zew
酾	zev	zev
醌	zdx	zdx
醑	zhv	zhv
醢	zuc	zuc
醭	znz	znz
醮	zrx	zrx
醵	zxr	zxr
醾	zxd	zxd
釐	plm	plm
銎	ebt	ebt
鋆	aft	aft
鋈	omt	omt
錾	plt	plt
鍪	clt	clt
鎏	ott	ott
鏊	qpt	qpt
鐾	njt	njt
钆	twe	twe
钇	twi	twi
钋	thb	thb
钌	ttl	ttl
钍	tat	tat
钎	txq	txq
钐	tis	tis
钒	tbz	tbz
钔	tem	tem
钖	twi	twi
钘	tck	tck
钤	trw	trw
钨	tzu	tzu
钪	tpb	tpb
钫	tyf	tyf
钬	txh	txh
钭	tld	tld
钲	tbe	tbe
钷	taj	taj
钹	tur	tur
钽	tbd	tbd
钿	tbt	tbt
铆	tym	tym
铈	tpz	tpz
铋	tna	tna
铌	tnw	tnw
铏	tcp	tcp
铑	taw	taw
铒	tfe	tfe
铕	tuv	tuv
铗	tms	tms
铘	taf	taf
铙	tql	tql
铚	tgi	tgi
铟	tgk	tgk
铣	tfk	tfk
铥	tvo	tvo
铧	tmu	tmu
铨	tkv	tkv
铩	ths	ths
铫	tkf	tkf
铴	toi	toi
铷	tgj	tgj
铹	tyi	tyi
铻	tvj	tvj
铼	tps	tps
铽	tqn	tqn
铿	tpa	tpa
锇	thq	thq
锊	tau	tau
锍	ttg	ttg
锏	ted	ted
锒	tzm	tzm
锓	tor	tor
锔	tnj	tnj
锖	tqv	tqv
锗	tae	tae
锘	tbu	tbu
锛	tkb	tkb
锜	tkx	tkx
锞	tbs	tbs
锟	tdx	tdx
锢	tgx	tgx
锧	twq	twq
锨	tln	tln
锩	tmc	tmc
锪	tfn	tfn
锫	tkj	tkj
锬	txx	txx
锲	tqk	tqk
锳	tbk	tbk
锴	txn	txn
锶	tbn	tbn
锸	txy	txy
锼	tyr	tyr
锽	tnv	tnv
锾	tar	tar
锿	tyj	tyj
镃	tsy	tsy
镄	tiq	tiq
镅	tnf	tnf
镆	tlm	tlm
镈	ttu	ttu
镋	tdk	tdk
镎	tgh	tgh
镏	tyb	tyb
镒	tsc	tsc
镔	tlt	tlt
镘	tqm	tqm
镛	txe	txe
镝	tkx	tkx
镞	tyv	tyv
镠	tni	tni
镡	tuu	tuu
镢	twn	twn
镤	tnz	tnz
镥	tzd	tzd
镦	tcl	tcl
镧	tes	tes
镨	tsd	tsd
镩	trr	trr
镪	tic	tic
镮	tcy	tcy
镱	tsn	tsn
镳	tax	tax
镴	tgy	tgy
镵	tzz	tzz
闩	eei	eei
闱	ehw	ehw
闳	euo	euo
闶	epb	epb
闼	eko	eko
闿	eea	eea
阂	eph	eph
阃	egs	egs
阇	eae	eae
阈	eqm	eqm
阊	edd	edd
阋	eyk	eyk
阌	eir	eir
阍	eyd	eyd
阏	eyf	eyf
阒	efp	efp
阕	etm	etm
阗	ent	ent
阘	edn	edn
阡	fxq	fxq
阱	fwj	fwj
阼	fra	fra
阽	fla	fla
陉	fre	fre
陎	fap	fap
陑	fhe	fhe
陔	fph	fph
陛	fxa	fxa
陞	faa	faa
陧	fml	fml
陬	ffr	ffr
陴	fgu	fgu
隃	fgp	fgp
隗	fgo	fgo
隧	fso	fso
隩	fsk	fsk
隰	fdx	fdx
隳	fuh	fuh
隹	ruu	ruu
隺	cru	cru
雉	vru	vru
雊	sru	sru
雒	oru	oru
雠	rir	rir
雩	ree	ree
雱	ryf	ryf
雳	rwi	rwi
霅	riy	riy
霨	rnu	rnu
霪	rov	rov
靬	zkg	zkg
靰	zlu	zlu
靸	zrj	zrj
靺	zpm	zpm
靼	zbd	zbd
靽	zsh	zsh
靿	zyi	zyi
鞁	zzp	zzp
鞒	zmn	zmn
鞔	zzk	zzk
鞡	zhk	zhk
鞣	zcs	zcs
鞧	zzq	zzq
鞨	zdp	zdp
鞫	zfi	zfi
鞬	zxo	zxo
鞮	zdh	zdh
鞯	zbu	zbu
鞲	zwa	zwa
鞳	zbg	zbg
鞴	zue	zue
韂	zqi	zqi
韨	hur	hur
韫	hdc	hdc
顸	kty	kty
颃	pbt	pbt
颋	vot	vot
颍	wit	wit
颎	wxt	wxt
颔	rwt	rwt
颙	brt	brt
颟	bet	bet
颡	rrt	rrt
颢	xty	xty
颥	rht	rht
飐	bhl	bhl
飑	bho	bho
飓	bht	bht
飔	bhn	bhn
飗	bhb	bhb
飧	xws	xws
餍	wpw	wpw
餮	xkw	xkw
饔	pyw	pyw
饧	wwi	wwi
饨	wej	wej
饩	wtq	wtq
饪	wvw	wvw
饫	wmt	wmt
饳	wjg	wjg
饻	wyi	wyi
馈	wcq	wcq
馉	wdg	wdg
馌	wac	wac
馏	wyb	wyb
馑	wzt	wzt
馔	wot	wot
馘	sdm	sdm
馝	wda	wda
馞	wdu	wdu
馧	wdc	wdc
驲	rdr	rdr
驵	rkq	rkq
驺	rqo	rqo
骀	roj	roj
骃	rgk	rgk
骈	rsc	rsc
骉	rrr	rrr
骋	rge	rge
骍	rfx	rfx
骎	ror	ror
骒	rbs	rbs
骕	rxt	rxt
骖	roi	roi
骘	fjr	fjr
骙	rtm	rtm
骠	rul	rul
骢	rsn	rsn
骣	rnu	rnu
骦	rrf	rrf
骧	ryw	ryw
骰	dts	dts
骱	dkn	dkn
骶	dyz	dyz
骷	dxg	dxg
骼	dog	dog
髀	dgu	dgu
髁	dbs	dbs
髃	dbr	dbr
髑	dcc	dcc
髡	ilu	ilu
髢	idy	idy
髦	iem	iem
髫	ima	ima
髭	ijw	ijw
髯	iga	iga
髹	ims	ims
髽	ika	ika
鬈	imc	imc
鬏	iwx	iwx
鬒	int	int
鬘	iqm	iqm
鬯	dgw	dgw
鬲	ugg	ugg
鬶	meu	meu
鬷	uhl	uhl
鬻	idu	idu
魃	gor	gor
魆	goi	goi
魈	gov	gov
魋	gor	gor
魑	gor	gor
鱽	zpd	zpd
鱾	zaj	zaj
鲀	zej	zej
鲂	zyf	zyf
鲃	zob	zob
鲅	zur	zur
鲆	zks	zks
鲇	zla	zla
鲈	zhn	zhn
鲉	zgy	zgy
鲊	zra	zra
鲋	zmu	zmu
鲌	znb	znb
鲏	zzp	zzp
鲐	zoj	zoj
鲒	zqj	zqj
鲕	zhe	zhe
鲖	zgm	zgm
鲗	zqp	zqp
鲘	zwm	zwm
鲙	zkt	zkt
鲚	zcn	zcn
鲝	izv	izv
鲟	zou	zou
鲡	zev	zev
鲢	zpo	zpo
鲣	zpa	zpa
鲥	zdu	zdu
鲦	zls	zls
鲧	zay	zay
鲩	zlk	zlk
鲪	zoj	zoj
鲫	zmc	zmc
鲬	zoe	zoe
鲭	zqv	zqv
鲮	zal	zal
鲯	zoq	zoq
鲰	zfr	zfr
鲱	zpf	zpf
鲲	zdx	zdx
鲳	zdd	zdd
鲴	zgx	zgx
鲵	zyk	zyk
鲷	zgq	zgq
鲹	zoi	zoi
鲺	zwc	zwc
鲻	zgb	zgb
鲼	zuq	zuq
鲽	zus	zus
鲾	zmb	zmb
鲿	zdt	zdt
鳀	zdh	zdh
鳁	zdc	zdc
鳂	zby	zby
鳅	zwx	zwx
鳇	znv	znv
鳈	zni	zni
鳉	zyu	zyu
鳊	zzy	zzy
鳏	zci	zci
鳑	zky	zky
鳒	zsn	zsn
鳕	zro	zro
鳘	tnz	tnz
鳙	zxe	zxe
鳚	znu	znu
鳛	znn	znn
鳜	zwn	zwn
鳠	zbr	zbr
鳡	zin	zin
鳢	zya	zya
鳣	zpb	zpb
鳤	zkd	zkd
鸤	nzn	nzn
鸧	kcz	kcz
鸨	wuz	wuz
鸩	ckz	ckz
鸪	xzn	xzn
鸫	vhz	vhz
鸬	hnz	hnz
鸱	yvz	yvz
鸲	szn	szn
鸶	yyz	yyz
鸷	hmz	hmz
鸸	hzn	hzn
鸹	fzn	fzn
鸺	msz	msz
鸻	pzn	pzn
鸼	lzn	lzn
鹁	fuz	fuz
鹂	evz	evz
鹆	czn	czn
鹇	esz	esz
鹈	sqz	sqz
鹉	eqz	eqz
鹋	bbz	bbz
鹌	kuz	kuz
鹍	dxz	dxz
鹎	guz	guz
鹐	qyz	qyz
鹑	cuz	cuz
鹒	xoz	xoz
鹔	xnz	xnz
鹕	xvz	xvz
鹖	dfz	dfz
鹘	dzn	dzn
鹙	wxz	wxz
鹚	syz	syz
鹛	nfz	nfz
鹝	uzn	uzn
鹠	ybz	ybz
鹡	ffz	ffz
鹢	stz	stz
鹣	soz	soz
鹦	qqz	qqz
鹧	xuz	xuz
鹨	nkz	nkz
鹪	rxz	rxz
鹬	cgz	cgz
鹮	cmz	cmz
鹯	pdz	pdz
鹱	zbr	zbr
鹲	yez	yez
鹴	rsz	rsz
麀	awb	awb
麇	awh	awh
麈	azv	azv
麋	adm	adm
麑	ayk	ayk
麖	ach	ach
麹	qld	qld
黇	ugl	ugl
黉	dug	dug
黝	syi	syi
黡	wps	wps
黥	sch	sch
黧	wfs	wfs
黪	soi	soi
黹	nwb	nwb
黻	nwr	nwr
黼	nwt	nwt
黾	jud	jud
鼍	dbu	dbu
鼐	vfy	vfy
鼒	uay	uay
鼗	kfr	kfr
鼙	puu	puu
鼢	ytp	ytp
鼩	ysj	ysj
鼫	yus	yus
鼱	yqv	yqv
鼷	yak	yak
鼹	ydg	ydg
鼽	dbm	dbm
鼾	dbk	dbk
齇	dbk	dbk
齑	cne	cne
龀	awb	awb
龁	atw	atw
龂	alj	alj
龃	akq	akq
龆	ama	ama
龉	avj	avj
龠	gdy	gdy
龢	gdw	gdw
鿍	ala	ala
鿎	uko	uko
鿏	tql	tql
𠅤	pbn	pbn
𠙶	tgk	tgk
𠳐	jqf	jqf
𡎚	azy	azy
𡐓	axi	axi
𣗋	sdk	sdk
𣲗	ohw	ohw
𣲘	ocu	ocu
𣸣	ouq	ouq
𤧛	vkz	vkz
𤩽	vup	vup
𤫉	vir	vir
𥔲	ude	ude
𥕢	uyd	uyd
𥖨	ujs	ujs
𥻗	dsb	dsb
𦈡	yrh	yrh
𦒍	kmn	kmn
𦙶	vxg	vxg
𦝼	vdg	vdg
𦭜	bjt	bjt
𦰡	bwf	bwf
𧿹	enm	enm
𨐈	pdl	pdl
𨙸	urf	urf
𨚕	obf	obf
𨟠	fff	fff
𨭉	cet	cet
𨱇	tiq	tiq
𨱏	tbg	tbg
𨱑	tug	tug
𨱔	tzu	tzu
𨺙	fyk	fyk
𩽾	zlg	zlg
𩾃	zzk	zzk
𩾌	zxi	zxi
𪟝	nil	nil
𪣻	adg	adg
𪤗	ani	ani
𪨰	eyq	eyq
𪨶	ekp	ekp
𪩘	eup	eup
𪾢	fej	fej
𫄧	yao	yao
𫄨	yhz	yhz
𫄷	ysn	ysn
𫄸	yxs	yxs
𫇭	bzz	bzz
𫌀	lne	lne
𫍣	igm	igm
𫍯	iim	iim
𫍲	iyr	iyr
𫍽	icy	icy
𫐄	plu	plu
𫐐	pyk	pyk
𫐓	pcs	pcs
𫑡	juf	juf
𫓧	tmf	tmf
𫓯	tvg	tvg
𫓶	tjv	tjv
𫓹	toq	toq
𫔍	tib	tib
𫔎	tcj	tcj
𫔶	eds	eds
𫖮	eat	eat
𫖯	kft	kft
𫖳	oat	oat
𫗧	wps	wps
𫗴	wpb	wpb
𫘜	rcw	rcw
𫘝	rak	rak
𫘦	rfb	rfb
𫘧	roi	roi
𫘨	rdh	rdh
𫘪	rwh	rwh
𫘬	rak	rak
𫚕	zpz	zpz
𫚖	jwz	jwz
𫚭	zgy	zgy
𫛭	pvz	pvz
𫞩	vbk	vbk
𫟅	ych	ych
𫟦	pso	pso
𫟹	tut	tut
𫟼	tko	tko
𫠆	urt	urt
𫠊	rpy	rpy
𫠜	ayk	ayk
𫢸	mvu	mvu
𫫇	jen	jen
𫭟	aah	aah
𫭢	akw	akw
𫭼	ayi	ayi
𫮃	avu	avu
𫰛	gre	gre
𫵷	ewi	ewi
𫶇	eyz	eyz
𫷷	xtn	xtn
𫸩	iah	iah
𬀩	dhw	dhw
𬀪	dej	dej
𬂩	sms	sms
𬃊	swq	swq
𬇕	oep	oep
𬇙	oqb	oqb
𬇹	ogl	ogl
𬉼	xah	xah
𬊈	xou	xou
𬊤	xvu	xvu
𬌗	agh	agh
𬍛	vyh	vyh
𬍡	owl	owl
𬍤	vou	vou
𬒈	dus	dus
𬒔	ujv	ujv
𬒗	upe	upe
𬕂	keq	keq
𬘓	ygc	ygc
𬘘	yck	yck
𬘡	ygk	ygk
𬘩	yvo	yvo
𬘫	ylk	ylk
𬘬	yqv	yqv
𬘭	ycl	ycl
𬘯	ycu	ycu
𬙂	ylg	ylg
𬙊	ysa	ysa
𬙋	yyw	yyw
𬜬	bej	bej
𬜯	bek	bek
𬞟	bjt	bjt
𬟁	buz	buz
𬟽	cvh	cvh
𬣙	ieu	ieu
𬣞	ile	ile
𬣡	ieq	ieq
𬣳	img	img
𬤇	iua	iua
𬤊	idh	idh
𬤝	itn	itn
𬨂	pyv	pyv
𬨎	pzq	pzq
𬩽	ouf	ouf
𬪩	zcy	zcy
𬬩	tqi	tqi
𬬭	tkw	tkw
𬬮	tic	tic
𬬱	tlj	tlj
𬬸	tsz	tsz
𬬹	tds	tds
𬬻	thn	thn
𬬿	tma	tma
𬭁	tnm	tnm
𬭊	tsa	tsa
𬭎	tlo	tlo
𬭚	tcu	tcu
𬭛	toz	toz
𬭤	tmv	tmv
𬭩	ttn	ttn
𬭬	tqo	tqo
𬭯	twl	twl
𬭳	tpj	tpj
𬭶	tsh	tsh
𬭸	tda	tda
𬭼	tso	tso
𬮱	eua	eua
𬮿	fea	fea
𬯀	fcn	fcn
𬯎	fcq	fcq
𬱖	gty	gty
𬱟	qwt	qwt
𬳵	rje	rje
𬳶	rgj	rgj
𬳽	rfk	rfk
𬳿	rkw	rkw
𬴂	rpf	rpf
𬴃	rqu	rqu
𬴊	rda	rda
𬶋	zsj	zsj
𬶍	zlw	zlw
𬶏	zqc	zqc
𬶐	zkf	zkf
𬶟	zpp	zpp
𬶠	zps	zps
𬶨	mcz	mcz
𬶭	ztl	ztl
𬶮	zpj	zpj
𬷕	tzn	tzn
𬸘	adz	adz
𬸚	piz	piz
𬸣	lwz	lwz
𬸦	ytz	ytz
𬸪	ibz	ibz
𬹼	akn	akn
𬺈	akx	akx
𬺓	ach	ach