的	nfz
了	tll
我	hqg
你	mqh
是	dhf
啊	jfx
不	jbb
有	uvy
都	afe
在	uat
就	chd
也	dyy
好	gui
人	krr
吧	job
说	ivk
这	cod
他	mdy
很	kmg
要	ugn
吗	jrm
去	aos
还	jod
和	wjk
看	hfm
会	kty
没	ots
想	sfn
呢	jnw
那	whf
么	aos
能	ovw
给	ygh
转	ptz
上	iss
来	psb
对	ruc
个	kcs
多	xxx
到	gpd
吃	jtw
做	mxl
过	uod
被	lzp
又	ryy
让	iis
太	kzd
最	dfr
她	gdy
爱	iur
用	eyy
把	hob
啦	jhk
大	kdd
小	hxx
得	kbu
才	uap
谁	iru
着	ifm
跟	emg
一	eii
再	nat
中	roo
哦	jhq
买	wfk
呀	jay
里	mll
真	ntb
下	ehb
图	glf
找	hqg
叫	jcj
但	mbd
比	xbb
年	tay
月	vyy
们	mem
请	iqv
嘛	jxc
走	doo
为	ziz
后	wme
点	lxh
更	pgg
像	mzx
男	bil
等	kws
求	iqq
嗯	jgn
只	jtb
死	xwb
事	mxv
话	ifs
与	ewe
它	lwb
笑	kmt
从	kkr
老	awb
当	dow
快	nak
逼	mbo
啥	jkf
完	ltk
玩	vtk
打	hrd
女	gnn
时	duc
哪	jwf
懂	nbm
问	ejk
挺	hvo
而	hee
别	jip
听	jlj
新	ksl
拍	hnb
出	jgk
您	mqn
前	svy
天	mtt
亲	ksm
可	xkk
哇	jvg
高	cgg
发	jry
带	yzj
心	nxx
钱	teq
美	ikd
睡	fxt
穿	ray
写	cee
哎	jbh
长	icc
地	ady
靠	fjp
先	fke
猫	pbb
见	ejj
该	iph
开	ckk
日	drr
哥	xxk
刚	ghp
拿	ghs
哈	jgh
成	iwe
之	bii
恩	gkn
总	vnx
却	aoc
家	lrs
住	mzv
阿	fxk
号	jek
傻	msl
回	dhh
无	cuu
已	aii
喵	jbb
滴	okx
牛	fnn
神	lds
哭	dpq
萌	bdv
喝	jdp
越	diu
水	iss
张	iic
加	ijk
花	bmw
分	tpd
帮	qfz
怕	nnb
黑	shh
卖	uwk
额	lot
鸡	rzn
字	lui
连	pod
二	tee
路	eog
学	dui
换	hqk
搞	hcg
早	dus
狗	psj
妈	grm
岁	exx
少	hap
干	kgg
送	smo
将	yxu
生	nss
跑	efo
难	rru
书	wwz
唉	jov
倒	mgp
贴	qla
脸	vgd
手	hss
算	kfb
放	ylx
拉	hkl
祝	ljk
版	ywr
画	ebg
错	tud
爆	xdi
起	daj
三	oss
行	pxx
以	wkr
猜	pqv
毛	emm
纸	yyv
于	eus
变	qry
并	sck
儿	kee
敢	wfl
装	yay
内	rnn
向	sjk
丝	yys
帅	pzj
呗	jqb
掉	hhu
擦	hll
姐	gkq
梦	cxx
特	fws
粉	dtp
冷	frl
车	pcc
陪	fkj
坐	kka
每	tnm
假	mnr
超	dma
咯	jog
站	kla
肉	rkr
谱	isd
星	dns
咋	jra
够	sxx
金	tjj
肿	vro
或	qme
讲	iwj
煮	axh
正	bee
累	bys
白	nbb
微	kbj
教	aul
哟	jyz
本	sei
照	dmx
第	kqk
全	kvw
弄	vbc
进	wod
读	iuk
马	rmm
胖	vsh
飞	wfb
活	ofs
俩	mek
唱	jdd
信	miy
头	fkd
子	uii
米	dmm
差	ieg
瘦	uyr
所	zlj
蛮	qcc
红	yeg
腿	vmo
王	vww
同	gme
某	ysm
咩	jiy
选	fko
黄	ugy
若	buy
热	hmx
久	qzd
骂	drm
抱	hfo
卡	ihb
聊	fym
些	jwt
忙	npw
远	tko
疼	ulf
网	ghh
噢	jsk
鸟	znn
苦	bxg
主	zvw
如	gjk
自	dii
卤	lhi
俺	mku
养	izn
店	xla
强	ijc
者	aee
富	lmb
忘	pnx
非	pff
考	aek
万	epd
贵	cqb
喔	jng
重	xml
收	clx
通	oeo
饿	whq
次	fnq
约	yfz
包	fos
亮	cbj
歌	xxn
型	cpa
种	wro
蛋	hcc
风	bhi
面	tmm
低	myz
君	oaj
元	tke
追	ado
赢	pjq
妹	gpw
破	uzp
此	jwb
贱	qeq
饭	wwr
火	xhh
摩	xch
球	viq
坏	ajb
李	sui
赞	fkq
其	oqq
呆	jsm
另	jil
挂	hvg
吓	jeh
系	ays
秒	wha
晒	dux
海	otn
羯	idp
离	phr
德	kun
跳	ekf
谈	ixx
度	xur
木	smm
团	gua
鱼	zvv
受	iry
山	ess
乱	fwe
力	ill
斯	olj
骗	rzy
疯	ubh
两	erk
弱	iff
菜	bic
翻	ibn
巴	obb
猪	pae
情	nqv
咱	jdi
条	lsm
刷	nzp
感	imn
按	hlg
西	uxx
恨	nmg
脚	vac
留	ybt
呃	jwc
偶	mbr
晚	dzx
办	itb
练	yvh
楼	sdg
定	lhf
雨	rvv
改	alx
安	lgn
双	rss
台	ojk
抢	hkc
组	ykq
道	sdo
愿	wnn
杀	hsm
洗	ofk
吐	jat
哒	jko
门	emm
宫	ljj
喂	jby
噗	jnz
闹	epz
伤	mti
处	lhb
耶	ffe
表	qyi
秀	wvn
曾	vdr
坑	apb
急	qon
乃	vnn
边	iod
郑	smf
报	hcr
撸	hzd
躺	gdj
呐	jrn
罗	cxx
往	kzv
国	glv
哼	jct
性	nns
片	ypp
蓝	bpc
喷	juq
机	sbj
陈	fvh
党	djk
八	tbb
配	zaj
管	kld
丫	scs
外	xhb
克	xke
达	kod
法	oao
树	sru
招	hma
爹	thx
口	jkk
城	aiw
入	krr
云	tyy
抓	hau
盘	lcm
药	byz
周	gqj
丢	vos
光	dlu
货	mwq
屎	ndm
油	ogy
病	uer
滚	oyo
林	cll
悲	pnx
乐	yhx
尔	qhx
词	iwm
捏	hml
相	sfm
催	mer
晕	dcp
五	vuu
四	css
叔	ihr
丑	wat
切	vpd
痛	uoe
顶	rty
吹	jnq
因	gkd
近	lod
名	xjk
嘴	jjq
戴	uqt
删	ypd
抽	hgy
气	tqq
块	aak
怪	nra
各	ogg
瞎	flj
件	mfn
半	shs
雷	rbt
作	mra
吖	jsc
混	odx
便	mpg
班	vpv
象	zxx
博	utu
唔	jvj
银	tmg
未	pww
摸	hlm
纯	yej
常	djz
深	ocs
短	vad
文	cww
咬	jfh
线	yeq
试	iqe
搜	hyr
直	nii
指	hwd
雪	row
几	bjj
呦	jyi
尿	nis
熊	ovx
毁	yet
利	wpd
眼	fmg
动	til
样	siy
明	dvy
奥	sdk
任	mvw
谢	igu
塞	lwa
戳	nrq
色	qob
段	hts
皮	zpp
平	ksb
夜	pml
虐	xow
酒	ozy
香	wdr
刘	cpd
控	hre
泡	ofo
床	xsm
空	reg
鞋	zvg
命	gjc
化	mwb
爬	aob
撒	hul
由	gyy
波	ozp
爪	auu
演	olg
查	sbd
合	ghh
灰	uxh
宅	lav
血	acm
宝	llv
则	qpd
粗	dkq
句	sjj
莫	lmm
诗	iws
款	aln
跪	eqc
类	dkd
关	smt
孩	uph
满	obk
房	zyf
茶	bks
操	hjs
土	att
凉	fch
冲	fro
流	otg
语	ivj
喊	jim
瓶	scm
帖	zla
整	plb
背	ywv
部	kjf
身	gss
队	fkr
科	wld
爸	tho
呵	jxk
爽	khh
待	kws
南	ugi
勒	zil
友	ury
斤	ljj
记	iaj
准	fru
龙	zll
输	pgp
草	bdu
单	vus
拼	hsc
念	rwn
吴	jmt
华	mwu
清	oqv
臭	dpq
接	hkg
枪	skc
汤	owi
豆	add
魔	xco
醒	zdn
票	uls
断	dwl
刀	pdd
杨	swi
杯	sjb
反	wry
郭	cuf
介	knd
理	vml
间	edr
题	dht
及	rjj
烂	xso
提	hdh
嘤	jqg
亿	mwi
群	oai
数	dgl
渣	osb
碗	ulc
胸	vfg
必	nap
交	fhi
骑	rkx
根	smg
方	yff
布	uzj
篇	kzy
丁	rdd
狠	pmg
停	mcr
份	mtp
汗	okg
尽	nzf
落	qog
省	haf
使	mmh
硬	upg
传	mtz
季	wui
欧	ahn
搭	hbg
且	kqq
左	ueg
握	hng
区	ahi
暖	dar
七	vqq
喽	jdg
潘	oib
泪	ofm
烦	xty
藏	bie
素	qys
基	oat
尼	nwb
乖	xyw
挑	hkf
穷	ril
春	qdr
至	gii
修	mli
街	pvg
北	ywb
棒	sqh
碎	upu
挖	hrw
级	yrj
排	hpf
节	bcj
趣	dfr
派	owy
慢	nqm
杜	sat
觉	dej
圆	gjq
六	fll
知	vjk
式	qeg
牌	ygu
咔	jih
桥	smn
致	glx
赚	qsn
救	ilx
补	lhb
虎	xbj
课	ibs
量	bml
粑	dob
绿	yoi
九	mjj
推	hru
折	hlj
忍	pzn
插	hxy
剪	svp
鬼	gos
套	kic
堪	aow
立	kll
师	pez
兔	zkz
投	hts
爷	thc
摔	hpu
嫁	glr
赛	lwq
借	mud
称	wqh
扔	hvn
屁	nxb
戏	rqg
百	ubb
砸	uaz
租	wkq
惹	bun
嗨	jon
腰	vug
胡	xvy
亦	qii
肥	vob
游	oyu
偷	mgp
懒	npq
妞	gwa
桑	rrs
味	jpw
撞	hkm
费	inq
甩	ewe
挤	hcn
墙	aad
东	vhx
佛	min
原	wnh
羊	iyy
亚	eny
奔	kub
扯	hji
场	awi
糖	dxj
苏	bit
蛇	clw
卷	mcj
吉	qjj
座	xka
淫	oav
娶	frg
堵	aae
皆	xnb
赵	dhi
解	qpf
期	ovy
踢	edi
底	xyz
韩	udh
森	scl
即	mcj
盖	icm
散	uvl
江	oeg
瑟	vva
槽	syd
涨	oii
笨	kse
熟	cux
齐	cnd
摆	hco
替	mmd
喜	pjk
位	mkl
调	igq
易	dfi
冰	fis
应	xdd
十	uss
拖	htd
格	sog
印	yec
淡	oxx
嘿	jsh
嘞	jzi
剩	wyp
娘	gzm
凭	mvb
体	mse
捡	hgd
偏	mzy
烧	xql
痘	uad
逛	pvo
旧	cdr
娃	gvg
升	abc
恋	qnx
岛	zes
鸭	gzn
甜	fyg
丽	evv
咪	jdm
电	udd
代	mqi
欲	cnq
史	jhi
寄	lkx
蝎	cdp
闲	esm
既	mcu
狼	pzm
声	ans
签	kgd
经	yre
什	mus
踩	eic
辣	fps
维	yru
呜	jzu
减	fim
公	tos
躲	gbs
狂	pvw
静	qvx
首	sdi
灯	xrd
占	laa
托	hav
涂	okw
奇	kxk
福	lmb
欠	nqq
烟	xgk
副	mbp
青	qvy
圈	gmc
烤	xae
射	guc
软	pnq
曼	qmm
遍	zyo
夏	tlx
撑	hdh
何	mxk
吵	jha
望	pvv
搬	hlt
英	bgk
仔	mui
脑	vpg
剧	nxp
抹	hpm
逗	aod
犯	pcj
界	bkn
怎	rnx
论	ikw
集	rsm
沙	oha
兰	sos
牙	ayy
物	ffi
惨	noi
压	waz
缺	bak
似	mwk
登	tad
咦	jki
截	uqr
食	wss
拔	hur
咧	jxp
器	dpd
归	pow
舔	fmh
湿	odn
窝	rjr
取	fry
运	tod
潮	ouv
朝	udv
足	euu
石	uss
麦	qlx
塔	abg
价	mkn
普	snd
汪	ovw
歪	jbe
果	bsm
诺	ibu
衣	yii
轻	pre
退	mod
结	yqj
嫌	gsn
薄	qtu
征	kbe
奶	gvn
症	ube
奖	yxk
忒	qnx
夹	msb
千	xqq
迷	dod
炒	xha
绝	yqo
随	fuo
古	xgg
船	lbj
帝	kzj
村	suc
扣	hjk
岂	eaj
厚	wdu
母	nmm
铁	tam
言	iyy
酸	zol
细	ybt
习	nxx
粘	dla
残	xeq
刑	cpd
晓	dql
诚	iiw
郎	zmf
矮	vwg
露	reo
军	cpc
右	uyy
证	ibe
梅	stn
拆	hlz
湖	oxv
精	dqv
建	xoy
举	dth
订	ird
麽	xco
田	btt
范	qcj
市	pzj
战	lqg
碰	usn
需	rhe
姓	gns
甚	owe
瞧	frx
猛	puc
嘉	pij
服	vcr
码	urm
值	mni
导	ouc
抄	hha
官	ldh
巨	aak
叶	jus
吊	jzj
泥	onw
妆	ygn
毒	qnm
治	ooj
锅	tjr
脱	vvk
思	bnx
萨	bfw
冠	ctu
灭	exh
仍	mvn
防	fyf
晨	dzc
吻	jfi
存	uui
弹	ivu
品	jdh
扑	hhb
宇	leu
宁	lrd
劝	ril
迪	god
耍	hgn
洛	oog
局	nwj
意	snx
愁	wxn
赶	dkg
笔	kem
音	syy
冒	dfm
邮	gfe
影	xis
蹭	evd
霜	rsf
朱	apw
婚	gyd
陆	fhg
驴	rzh
蟹	qpc
丹	gpp
峰	elq
粮	dzm
扎	hwe
害	lqj
嫩	gpl
蒸	bwx
困	gsm
零	rrl
哄	jut
炮	xfo
魂	tgo
现	vej
艾	bhi
捉	heu
河	oxk
紧	pry
工	egg
胜	vns
终	ylf
播	hib
隔	fug
炸	xra
封	vuc
孙	uhx
噶	jbp
劲	rei
圣	rat
炖	xej
雾	rli
唐	xxj
蹲	ezu
股	vts
申	dss
唯	jru
透	wvo
威	ieg
然	vpx
劈	njp
据	hnx
纳	yrn
酱	yxz
熬	qpx
遇	bro
憋	wln
醉	zpu
昂	dyc
舟	loo
案	lgs
舞	tba
酷	zfj
磨	xcu
令	rll
玉	lvv
刮	fpd
野	mcv
割	lqp
答	kgh
冻	fvh
著	bae
联	fsm
容	lcg
刺	npd
客	log
互	eow
贝	qbb
永	zis
夫	mff
蒂	bkz
宽	lbe
阳	fdr
吸	jrj
墨	sat
板	swr
较	pfh
初	lpd
冥	cdf
伊	moa
编	yzy
针	tus
略	bog
菇	bgx
瓦	mww
梁	ops
伟	mhw
屋	ngi
率	pyu
智	vjd
观	rej
己	ajj
世	uwe
秋	wxh
角	qjj
寸	ucc
贼	qqu
跌	eam
佳	mvg
骚	rrc
伞	ksu
鼻	dbl
凶	hgk
具	ktb
夸	kee
缘	yor
园	gtk
湘	osf
剑	gdp
曲	yqq
架	ijs
凑	fqm
淘	ofb
志	anx
降	fla
徐	kkw
瓜	agg
弯	qig
啃	jjv
民	bmm
纹	ycw
闪	ekr
泰	qis
蒙	yer
揍	hqm
飘	ulh
趁	dki
遭	ydo
扒	htb
守	luc
帐	zic
广	xgg
吾	vjk
轮	pkw
负	qqb
雅	aru
仅	mry
忧	ndy
暴	dui
极	srj
卧	ehb
孔	uwe
扫	how
盯	frd
怒	grn
共	utb
灵	oxh
钻	tla
造	fjo
恶	enn
善	isj
腻	vqq
嗷	jql
沈	ock
标	sls
众	kkk
胃	bvy
许	itu
步	jhx
盒	gcm
浪	ozm
瞅	fwx
罪	cpf
景	xjj
谷	cgg
麻	xcl
闻	efe
恤	nac
录	ois
院	flk
抠	hah
紫	jwy
饼	wsc
肌	vbj
趴	etb
付	muc
叠	rrk
液	opl
凤	bry
堆	aru
锁	tdq
败	qlx
耳	fee
戒	qbc
顺	gty
属	nar
废	xjr
领	rty
乳	auw
揉	hcs
秤	wks
睇	fsq
业	nyy
虽	jcc
寻	ouc
啰	jcx
独	pcc
吼	juw
坨	alw
甘	ygg
朵	bsm
显	dny
凡	bzd
搓	hie
馋	wzf
料	dld
川	gcc
薇	bkb
康	xxi
寒	lwf
港	ouo
猿	pay
翔	inv
脏	vxa
狮	ppz
供	mut
玛	vrm
钟	tro
屏	nsc
除	fkw
优	mdy
权	sry
姆	gnm
实	lfk
震	rzc
温	odc
糗	ddp
冯	frm
侠	mms
赌	qae
阴	fvy
今	rwe
捧	hqh
伯	mnb
州	dgc
含	rwj
备	lbt
虾	ceh
顿	ejt
壳	fbj
居	nxg
氏	yvq
员	jqb
评	iks
伴	msh
镇	tnt
耐	huc
敲	cxd
洞	ogm
牵	kcf
罚	cip
拜	heq
摇	hab
曹	ydr
攻	elx
斗	ldd
绕	yql
依	myi
汉	ory
馆	wld
披	hzp
响	jsj
宗	lls
染	oms
董	bxm
掰	hth
京	chx
蠢	qdc
仙	mes
届	ngy
呸	jje
浓	ocy
松	sto
敬	bsl
砍	unq
兽	vme
摄	hfr
腾	vmr
杰	sxh
否	jjk
虫	ccc
俊	mol
武	eqj
免	zke
争	qxv
袁	ajy
伐	mqg
复	tdl
莱	bps
壮	yas
制	fzp
保	mjs
蜜	lnc
咳	jph
扇	znv
萧	bxt
测	oqp
滑	odg
埋	aml
虚	xny
帕	znb
贪	rwq
妮	gnw
旺	dvw
盆	tpc
饱	wfo
妖	gmt
犬	pqq
巧	eek
列	xpd
尾	nem
甲	gjj
颗	bst
膜	vlm
堂	dja
密	lne
哆	jxx
怀	njb
捂	hvj
鲁	zdr
啪	jhn
商	ktj
宋	lsm
认	ikr
慌	nbg
捞	hyi
环	vjb
缩	ylu
粥	idi
妙	gha
骨	dgg
勿	fis
展	nuy
继	ydw
失	amf
晃	ddl
洋	oiy
章	sus
铺	ttf
兵	ltb
镜	tsk
於	ykf
倍	mkj
挡	hdo
遮	xuo
室	lgi
财	qua
漏	onr
烫	owx
税	wvk
溜	oyb
库	xpc
士	ass
瑞	veh
甄	uam
豪	crs
消	odv
轰	prs
仁	mte
亏	eek
浅	oeq
煎	svx
沉	ocb
芙	bmf
抗	hpb
端	keh
颜	kwt
顾	wct
兄	jke
龟	qud
希	huz
告	fjk
航	lpb
闷	enx
健	mxo
盐	ahc
键	txo
乔	mnd
伦	mkw
抛	hmi
窗	rsl
肯	jvy
寺	wss
层	nty
社	lat
划	qpd
冬	lfb
碧	vnu
痒	uiy
裤	lxp
咸	ime
围	ghw
尚	djk
弃	tbc
档	sdo
支	ury
获	bpp
嘎	jtq
识	ijt
菲	bpf
惊	nch
漫	oqm
横	sug
兴	dtb
餐	xrw
余	kwh
休	msm
幅	zmb
敷	tyl
嬛	gcy
逆	sjo
怂	kkn
暗	dsy
垫	hma
晴	dqv
串	rro
娇	gmn
拌	hsh
稳	wqn
刻	ppd
视	lej
页	tyy
悦	nvk
宠	lzl
炫	xpy
族	ytv
猴	pmv
膏	cvy
状	ypq
竟	ske
填	ant
剃	sqp
故	xlx
聚	fri
逃	kfo
琴	vvw
燕	ujx
叼	jwe
形	cis
腹	vtl
产	kwc
礼	lwe
泽	orh
鼠	yss
目	fmm
薛	baf
私	wos
赖	pqq
蔡	btl
伪	mzz
欢	rnq
候	mak
澡	ojs
桌	hds
沾	ola
拽	hda
尖	hkd
侧	mqp
姑	gxg
凯	eab
砖	utz
胶	vfh
肾	prv
曰	drr
井	wjj
执	hmz
缠	yxm
侬	mcy
彭	pis
祸	ljr
校	sfh
设	its
叹	jry
彩	iis
攒	hfq
驾	ijr
娜	gwf
旁	kyf
袋	mqy
霾	rpm
专	twz
源	owh
竹	kuu
挠	hql
梗	spg
厂	wcc
肺	vnc
蹦	eev
功	eil
舍	kfs
惯	nnq
泉	nis
研	uck
盼	ftp
译	irh
漂	oul
斜	kwl
稍	wdv
限	fmg
祖	lkq
俗	mcg
翘	qln
赏	djq
荷	bmx
柯	sxk
邓	rfe
尊	zuc
施	ytd
损	hjq
挣	hqx
严	enw
贾	uqb
崔	eru
扭	hwa
踹	eeh
抖	hld
须	ity
户	zhh
樱	sqg
宜	lkq
摘	hkx
稿	wcg
嘘	jxn
绳	yju
蒋	byu
赤	any
净	fqx
均	aff
宏	luo
衰	ygt
末	pmm
沃	omt
计	ius
般	lts
蕾	brb
坤	ads
艺	bwi
移	wxx
持	hws
赔	qkj
捐	hjv
童	kml
县	kos
撤	htl
禁	cls
始	goj
趟	ddj
索	fys
乘	wyw
距	eaa
政	blx
歇	dfn
罐	bbr
医	avs
裸	lbs
勇	oei
弟	sqk
慧	qqn
捅	hoe
柳	sym
欣	lnq
批	hxb
拒	haa
塘	axj
溪	oak
胆	vbd
旅	yty
逢	lqo
程	wjv
乡	yxx
醋	zud
默	spq
义	zhi
荣	ysm
撕	hol
莉	bwp
糊	dxv
洪	out
僧	mvd
核	sph
鲜	ziy
帽	zdf
鑫	ttt
贺	ijq
掐	hqy
悬	kon
焦	rxh
硕	uty
浮	oau
兼	son
乌	zuu
采	icc
沪	ozh
靓	qve
坟	acw
哩	jml
尸	nss
庆	xkd
莎	qha
枰	sks
皇	nvw
池	ody
盛	iwc
挨	hov
简	ked
乎	asu
芳	byf
呼	jau
扛	heg
鼓	pur
赫	ann
珞	vog
碟	uus
充	tke
哉	uqj
辞	ffx
仇	mmj
勾	fos
跨	eke
钢	tgh
拱	hut
皂	nvq
侯	mav
杂	msm
啧	jne
止	jii
摊	hrr
钓	tfz
朗	zmv
仓	kcj
姜	ign
苗	bbt
秦	qwh
隆	fln
惠	tcn
判	shp
引	ics
搅	hde
衫	lis
剁	bsp
舒	kfc
啵	joz
卸	bcj
葱	bfn
添	omh
裙	loj
扬	hwi
谦	isn
嗦	jfy
扮	htp
拨	hjr
勤	zti
职	fjt
丸	mzd
盗	fnc
兹	syy
蝶	cus
曝	ddi
矣	ovs
莲	bpo
努	gri
雄	uor
稀	whz
菊	bfd
临	pkd
嗲	jtx
沟	ofo
辆	pek
湾	oqi
剥	oip
宿	lmu
饮	wnq
桶	soe
速	pod
境	ask
痣	uan
扶	hmf
舌	fss
糟	dyd
腐	xmk
忠	rnx
护	hzh
琪	voq
熙	eox
朕	vsm
术	szd
闯	erm
颠	ntt
幸	aiy
靴	zmw
陷	fqy
佩	mbz
酥	zwh
迟	nzo
孤	uag
羞	iwa
棋	soq
臀	nuv
父	thi
绑	yqf
润	oev
项	ety
犹	pdy
魏	wgo
创	kcp
嚯	jrr
珊	vyc
庄	xat
毕	xus
肩	zvy
扁	zyc
裂	xpy
肚	vat
禅	lvu
糕	dix
附	fmu
旗	yto
橙	sta
汁	ous
侃	mjg
枝	sur
砂	uha
纪	yaj
凹	gei
唇	zjk
仨	mos
枕	sck
琳	vcl
邦	qfe
鲍	zfo
厄	wcj
磕	uac
竖	prk
邪	afe
辩	fif
孟	ucm
胎	voj
迎	yco
拳	mhs
箱	ksf
渡	oxr
拾	hgh
质	wuq
卢	hns
挫	hka
咖	jij
卓	hdu
忌	anx
叻	jil
轴	pgy
拧	hlr
增	avd
载	uqp
颇	zty
榜	sky
仲	mro
嫂	gyr
嘻	jpj
搂	hdg
肠	vwi
嚼	jau
詹	qwi
购	qfo
朴	shb
助	kil
锦	tnz
异	obc
粽	dll
宰	lfx
织	yjt
愣	ncy
敌	flx
洁	oqj
穆	wni
埃	aov
咒	dbj
杆	skg
庙	xgy
杠	seg
途	kwo
敏	tnl
决	fak
噜	jzd
吞	mjk
柔	csm
鹏	vvz
珠	vap
驻	rzv
柜	saa
瞄	fbb
坎	anq
剂	cnp
孝	aui
斑	vcv
轩	pkg
黎	wfi
掌	djh
抬	hoj
幂	cdz
黏	wkl
规	mej
瑕	vnr
粪	dut
肝	vkg
鹿	all
罢	cao
辛	fxx
玮	vhw
弗	ind
良	zmg
慎	nnt
臣	ecc
熏	xsh
缝	ylo
钗	trz
崩	evv
慕	lhx
积	wjt
赐	qdi
勺	fzd
姚	gkf
梨	wps
喇	jpp
浩	ofj
谨	izt
俄	mhq
芬	btp
凌	fal
坡	azp
昌	ddr
颤	pdt
卫	cei
嗒	jbg
洒	oux
赠	qvd
农	cyi
芯	bnx
参	oki
籽	dui
霍	rru
柴	jws
拐	hji
贤	prq
崽	ebn
皱	qoz
削	dvp
婊	gqy
秘	wna
阅	evk
承	wio
骆	rog
搁	heo
祭	tls
劫	aoi
罩	chu
筋	kvi
厅	wrd
闭	eua
肖	dvy
辉	dlp
洲	odg
危	qwc
拎	hrl
妻	xgn
掏	hfb
汇	oak
雕	gqr
眉	nfm
吕	jjk
惟	nru
赴	dhb
阵	fpc
珈	vij
尤	dyy
夺	kuc
巾	zjj
忽	fin
鹅	hqz
涅	oml
泼	ojr
警	bsi
凸	vei
傲	mql
耗	tse
桃	skf
盲	pfm
楚	chf
玲	vrl
塌	adn
注	ozv
渐	opl
灌	obr
岭	erl
俞	gvp
返	wro
琼	vch
脉	vzi
堡	mja
择	hrh
携	hrv
佬	maw
恒	neb
册	ycc
郝	anf
膘	vul
艳	qqo
企	kji
席	xuz
慈	syn
阔	eof
触	qcc
啾	jwx
锋	tlq
哲	hlj
壶	fny
岗	egh
司	wme
训	igc
模	slm
讯	iwu
兜	nyk
宾	llt
陶	ffb
寿	quc
唷	jtv
喘	jeh
霸	rzv
痴	uvj
噻	jla
鸣	jzn
尹	oap
兮	tek
遛	ybo
劳	yil
梳	stg
仕	mas
逸	zko
徒	kdo
箭	ksp
铅	tbj
束	pss
误	ijm
脖	vfu
币	azj
刊	kpd
欺	onq
庭	xvo
妥	agn
鸿	oez
揪	hwx
仿	myf
续	yuk
怡	noj
予	cvv
仑	kwb
尝	dty
锤	txt
激	onl
炎	xxh
翼	nbt
序	xcv
宣	leb
怨	xcn
态	kzn
疤	uob
滨	olt
弦	ipy
迈	epo
鹰	xmz
唠	jyi
婆	ozg
澳	osk
菌	bgw
卯	ymm
茜	bux
雯	rcw
拦	hso
眠	fbm
券	mpd
乜	wwe
债	mne
亭	crd
窄	rra
饶	wql
宴	ldg
框	sav
棍	sdx
丰	qff
契	qpk
勃	fui
覆	ukl
患	rrn
脆	vqc
邱	lef
铲	tkw
叉	rzd
俏	mdv
悟	nvj
脂	vwd
喻	jgp
御	kbc
倩	mqv
枚	slx
险	fgd
尘	hat
裹	ybs
牢	lfn
粒	dkl
探	hcs
蜂	clq
技	hur
寂	lir
韦	hww
婷	gcr
幻	ywe
岩	eus
贫	tpq
延	ajo
奏	qmt
柏	snb
疑	wvh
蒜	bll
哀	yjk
审	lds
幕	lzj
妃	gaj
姿	fng
亡	pww
蘸	bzx
翠	npu
鼎	fyy
尺	nzd
诸	iae
唰	jnp
抵	hyz
煲	mjx
振	hzc
置	cni
葛	bdp
腔	vre
馅	wqy
浇	oql
恐	ebn
呛	jkc
忆	nwi
憨	wfn
愈	gvn
藤	bvi
虹	ceg
售	rjk
坛	aty
逮	xio
瞪	fta
葬	bxb
棉	snz
隐	fqn
缓	yar
铜	tgm
踏	eid
避	njo
孕	vui
拙	hjg
彼	kzp
屯	ejc
筒	kgm
斩	plj
息	dnx
递	sqo
巷	uto
誉	dti
戈	qgg
营	yjj
讨	iuc
绒	yqu
融	ucc
喃	jui
昏	yvd
势	hmj
浴	ocg
跃	emt
潜	omd
纽	ywa
惜	nud
仗	meh
磅	uky
访	iyf
闺	evg
媛	gar
漆	osi
沫	opm
韵	sff
陵	fal
奉	qhs
谍	ius
仪	mzh
垮	ake
绘	ykt
瑜	vgp
适	fod
协	uit
迁	xod
启	zjk
姬	gec
培	akj
乙	wii
枣	nfb
篮	kpc
监	pkc
央	gkd
揭	hdp
垂	xbt
冤	czz
绮	ykx
葵	btm
煞	qox
栏	sso
傅	mtu
涛	oqu
议	izh
恕	gjn
霞	rnr
蛙	cvg
谋	iys
伏	mpq
销	tdv
恰	ngh
盾	wuf
龄	arl
奈	kls
焖	xen
壹	fad
瞒	fbk
袜	lpm
伸	mds
坊	ayf
妇	gow
邀	nyo
裁	uqy
幼	yil
睁	fqx
翁	ton
羽	nvv
亨	ctl
萱	blb
瓷	fnm
墓	lat
妍	gck
映	dgk
幽	eyy
晾	dch
奴	gry
娅	gen
拣	hvh
屈	njg
玄	pyy
吨	jej
茬	bua
兆	kff
棕	sll
倾	mwt
燥	xjs
辈	ppc
掺	hoi
栽	uqs
磊	uuu
账	qic
历	wil
暮	ldr
芽	bay
钉	trd
估	mxg
飙	pph
鞭	zmp
帆	zbz
押	hgj
涮	onp
玻	vzp
捷	hxh
笼	kzl
链	tpo
豹	pfz
噎	jfa
委	wgn
淋	ocl
府	xmu
哔	jxu
庸	xxe
楞	scy
岳	lee
媒	gys
纲	ygh
黛	mqs
番	ibt
杏	sjk
毅	krt
纵	ykk
摁	hgn
禾	whh
绛	yla
撮	hdr
享	cui
袭	zyi
逝	hlo
突	rpq
泌	ona
柱	szv
击	hgk
秃	wbj
律	kxv
浦	otf
责	nee
叽	jbj
岸	ewk
绣	ywv
馨	and
哑	jen
涌	ooe
炜	xhw
务	lil
旭	mdr
荒	bpg
暂	pld
懵	nbf
龚	zut
坚	pra
欸	ovn
妄	pgn
窜	rrr
锐	tvk
霄	rdv
琦	vkx
察	ltl
茨	bfn
悔	ntn
捶	hxt
允	oke
哨	jdv
济	ocn
资	fnq
斌	cej
奸	gkg
芦	bzh
厉	wep
俱	mkt
宥	luv
薪	bkl
郁	uvf
藕	btr
雀	hru
桂	svg
苍	bkc
畅	dwi
仰	myc
兑	vke
竞	kjk
丘	lei
措	hud
瘫	urr
逐	rod
灿	xes
荡	qwi
廷	voy
邵	mfe
齿	acc
咽	jgk
廊	xzf
酿	zzm
钩	tfo
弓	igg
垦	mat
臂	njv
浆	yxi
涩	opj
捕	htf
楠	sui
汀	ord
伍	mvu
姨	gki
癖	unf
誓	hli
囤	gej
瘾	ufn
搏	htu
挽	hzk
颖	wwt
呲	jjw
疾	uvs
撩	hkh
枉	svw
嗑	jac
悠	mln
蛆	ckq
渝	ogp
璐	veo
祥	liy
浑	ocp
匀	ffb
符	kmu
脾	vgu
焚	cxh
呈	jvw
宪	lfk
昆	dxb
椅	skx
铊	tlw
阁	eog
涵	owg
滩	orr
艰	rmg
芭	bob
囊	fdy
蹬	eta
隅	fbr
刨	fop
萝	bcx
壁	nja
吟	jrw
繁	tny
腚	vlh
丙	ern
碳	uex
钙	tew
坦	abd
茧	bcc
典	ytb
彪	xbi
泄	ouw
揽	hpe
棵	sbs
骏	rol
貌	pnk
佟	mlf
嘚	jku
娟	gjv
掩	hku
卒	pku
巫	ekk
卵	yll
徽	kys
哗	jmu
挪	hwf
育	tvy
佐	mue
祛	lao
颈	ret
佑	muy
枯	sxg
辰	zcc
夕	xxx
效	fhl
糙	dfo
葡	bft
栋	svh
益	stc
敦	cul
辱	zuc
午	tus
验	rgd
卿	ymg
眯	fdm
策	knb
丧	asy
津	oxv
陌	fub
靖	kqv
痰	uxx
苑	bxc
孽	bau
笋	koa
昭	dma
挥	hcp
灶	xat
帘	rzj
诛	iap
珍	vki
舰	lej
圭	vgg
嫖	gul
铃	trl
驱	rah
贯	nqb
释	irh
聪	fvn
滕	vmi
谎	ibg
瓣	faf
预	cty
扰	hdy
泛	oab
矿	uxg
掖	hpl
谭	iuu
椒	sir
例	mxp
傍	mky
厨	wau
屹	etw
铭	txj
谜	ido
吱	jur
晶	ddd
颂	tot
纬	yhw
鹤	crz
萍	qks
纱	yha
匠	alj
潭	ouu
综	yll
铝	tjj
斋	che
涉	ojh
廖	xni
蔻	blx
镐	tcg
狐	pag
谓	ibv
嗅	jdp
炭	eux
莹	ylv
频	jht
婶	gld
献	ugp
喉	jmv
屠	nae
匹	ake
妾	kgn
梵	cbz
遗	cqo
愚	brn
烈	xpx
晋	end
淹	oku
桩	sxa
俾	mgu
嚓	jll
撅	hwn
昊	dmt
牧	flx
殿	nut
甭	jey
癌	uje
蜡	cud
泳	ozi
灾	lxh
禄	loi
痕	umg
喆	qqj
绍	yma
详	iiy
贞	hqb
畔	bsh
卦	vhb
溢	osc
蚝	cem
寨	lws
啤	jgu
拓	hus
霉	rtn
厝	wud
咕	jxg
崴	eig
棚	svv
厌	wpq
貂	pma
镁	tik
倪	myk
寡	ltp
翅	urn
隽	rvn
嘭	jpi
梓	sfx
荤	ypc
崖	ewv
杭	spb
寝	lyr
渴	odp
辨	fpf
妓	gur
殇	xti
舱	lkc
材	sua
恃	nws
榛	sqw
阻	fkq
袖	lgy
究	rmj
烙	xog
嚷	jyw
矛	cmm
恼	npg
掀	hln
耀	dlr
撇	hwl
嚎	jcr
怜	nrl
炉	xzh
栅	syc
硅	uvg
彦	kwi
刹	hsp
戚	iih
驼	rlw
蒽	bgn
坪	aks
泷	ozl
肤	vmf
嗡	jtn
巢	gbs
授	hir
皿	cmm
晏	dlg
轶	pam
瑶	vab
裆	ldo
蹄	ekz
嘟	jaf
径	kre
渔	ozv
熄	xdn
籍	ktd
灸	qzx
禽	kpr
窦	ruk
扩	hxg
乍	raa
婵	gvu
穴	rxx
耻	fji
谣	iab
镶	tyw
俯	mxu
陀	flw
蜀	cfc
钦	tnq
凝	fwh
倚	mkx
裕	lcg
卜	hbb
缸	beg
沿	obj
拥	hey
捣	hze
阉	eku
储	mia
蓉	blc
噔	jta
匿	abu
确	uqj
芝	bbi
吒	jav
莓	btn
躁	ejs
僵	mee
呕	jah
垵	alg
彤	gpi
捎	hdv
蛤	cgh
畏	bey
叙	kwr
毙	xxw
氧	tiy
焉	bex
獒	qpp
彻	kvp
浙	ohl
盟	dvc
腥	vdn
蔚	bnu
叮	jrd
拟	hwk
迅	wuo
嗔	jnt
靡	xcp
橘	scj
统	ytk
迹	qod
雇	zru
乏	abi
宵	ldv
碑	ugu
胀	vic
锥	tru
疗	utl
担	hbd
遥	abo
盏	eqc
聂	frs
污	oee
援	har
芊	bxq
茄	bij
扳	hwr
觅	aej
励	wei
昨	dra
嗝	jug
瘪	udw
丛	kke
稠	wgq
郅	gfe
轨	pmj
醇	zcu
奕	qkd
燃	xvx
锡	tdi
崇	ell
溅	oqq
芮	brn
煤	xys
啸	jxt
瘤	uyb
笈	krj
撬	hee
茂	biu
钵	tse
珀	vnb
畜	pyb
硫	utg
坠	fka
泊	onb
隋	fuv
瞟	ful
杉	sis
枫	sbh
榨	srr
邹	qof
腌	vku
泯	obm
揣	heh
氪	txk
儒	mrh
奢	kae
棱	sal
渗	ooi
焕	xqk
阎	eqy
艘	lyr
辽	tod
违	hod
磁	usy
溶	olc
绞	yfh
浸	oor
潇	obt
舅	ybi
媚	gnf
诉	ilz
骄	rmn
茱	bap
弥	iqh
滋	osy
瞭	fkh
膝	vsi
茵	bgk
蓬	blo
巡	god
汝	ogn
窥	rme
肛	veg
阶	fkn
淌	odj
渤	ofi
蚊	ccw
蝉	cvu
逊	uho
愤	nuq
荼	bkw
骁	rql
栓	skv
犊	fuk
猎	pud
嘀	jkx
笛	kgy
辑	pjf
聘	fge
苔	boj
疏	htg
腊	vud
寇	ltx
攀	chh
曦	diq
踪	ell
虑	xnx
贷	mqq
鲸	zch
喳	jsb
域	aqm
缴	ynl
螺	cby
滇	ont
叭	jtb
晖	dcp
固	gxg
檀	spb
睿	xtf
谤	iky
赋	qej
窃	rvp
闫	eos
蓄	bpb
淇	ooq
朋	vvy
瑾	vzt
坞	azu
雁	wmr
咻	jms
恭	uth
拷	hae
碍	ubu
召	maa
豁	lqc
颁	tpt
魄	ngo
桓	seb
澜	oes
椰	sff
瘟	udc
盈	vrc
徕	kps
滥	opc
弧	iag
惶	nnv
禹	ajr
魅	gop
嗳	jir
筛	kpz
倦	mmc
旋	yth
检	sgd
氢	tre
芒	bpw
跶	eko
遂	sro
钞	tha
倔	mng
脓	vcy
陟	fjh
樊	chk
刁	wei
萎	bwg
逾	gvo
炼	xvh
莪	bhq
吆	jyy
咏	jzi
茹	bgj
蔫	bbx
悍	ndk
槟	slt
缕	ydg
塑	sja
舵	llw
锣	tcx
喏	jbu
恁	mvn
痞	ujj
麟	ada
溯	osv
趋	dqo
拴	hkv
遁	wuo
旱	dkg
鸽	gzn
娄	dgn
娱	gjm
寅	leg
抚	hcu
植	sni
榕	slc
嗓	jrs
恢	nux
饰	wtz
楷	sxn
滤	oxn
腮	vbn
漾	oii
粤	sde
铛	tdo
腺	vni
筐	kav
叨	jpd
弩	gri
慰	nln
莺	yzn
娴	ges
蛊	ccm
遵	zuo
搽	hbs
乒	lea
奎	kvg
瑛	vbk
牲	fns
荫	bfv
辫	fyf
鉴	pkt
雌	jwr
颓	wbt
忻	nlj
梯	ssq
矗	nnn
矫	vmn
焗	xnj
抡	hkw
珂	vxk
督	ihf
矬	vka
伶	mrl
婉	glc
昧	dpw
绊	ysh
询	ifd
厮	wol
肃	xnt
趾	eji
述	szo
邢	cfe
酮	zgm
辅	ptf
螨	cbk
裱	lqy
怖	nuz
捆	hgs
廉	xsn
皓	nfj
眨	fab
衬	luc
纶	ykw
镑	tky
呱	jag
斥	lzd
歉	son
蒲	qtf
诱	iwv
贡	eqb
咚	jlf
嫦	gdz
柚	sgy
窑	rbf
毫	cem
耙	tso
蕉	brx
示	lss
耕	tsw
吭	jpb
渺	ofa
辕	pay
阜	adu
匪	apf
暑	dae
玫	vlx
筑	kez
喀	jlo
炕	xpb
霖	rcl
泣	okl
烘	xut
芋	beu
剖	kjp
唤	jqk
桔	sqj
町	brd
筹	kqu
绵	ynz
荆	bcp
渊	ond
咿	jma
岑	erw
株	sap
淳	ocu
耸	kkf
驰	rdy
苯	bse
辟	njf
恬	nfs
迫	nod
勋	jqi
奋	kbt
叁	oko
嘣	jev
墩	acl
栖	sux
竿	kkg
贸	yqb
阮	ftk
偿	mdt
庞	xzl
泻	oce
袄	lmt
冈	ghi
篱	kpr
绷	yvv
堤	adh
癣	uzi
贬	qab
凳	tab
闵	ecw
璇	vyh
榆	sgp
吡	jxb
崎	ekx
煨	xby
霎	rkg
拂	hin
淑	oir
伙	mxh
婴	qqg
缇	ydh
跋	eur
糯	drh
促	meu
昕	dlj
毯	exx
痨	uyi
杵	stu
吽	jfn
羡	ifn
蛹	coe
弘	ios
岚	ebh
暇	dnr
瘸	uik
艇	lvo
钰	tlv
嚣	dtd
嵩	ecg
秉	wow
厕	wqp
嗤	jjc
娼	gdd
巳	oss
嬴	pjg
瀚	oun
茅	bcm
览	pke
遣	cdo
弊	wlb
膨	vpi
碘	uyt
馊	wyr
侵	mor
庇	xxb
缪	yni
褪	lmo
砰	uks
馍	wlm
垢	awm
孰	cuz
暄	dlb
障	fsu
歼	xxq
狸	pml
眈	fck
岔	tpe
邻	rfe
雍	pyr
砌	uvp
擤	hdl
胯	vke
嗖	jyr
郜	fjf
馥	wdl
罕	ctk
冉	gat
嗜	jad
囚	gkr
屡	ndg
庚	xok
栗	usm
疆	iae
诊	iki
恺	nea
捋	hau
摞	hby
旦	bdd
铮	tqx
碾	uny
缁	ygb
蕃	bib
贰	qtq
俐	mwp
酉	zyy
饺	wfh
袅	zyi
汽	otq
浊	occ
茎	bre
掂	hxl
耽	fck
佰	mub
堕	fua
杖	seh
癫	unt
勉	zki
皎	nfh
矢	vss
怯	nao
掷	hsf
坂	awr
蟒	cbb
乾	udw
狄	pxh
眷	mfm
稻	way
肘	vuc
唬	jxb
诈	ira
钧	tff
劣	hai
函	wig
撂	hbo
盹	fej
蕊	bnn
坝	aqb
朦	vyr
瘀	uyf
幺	yyy
沁	onx
纤	yxq
啷	jzf
擒	hkr
啼	jkz
殷	wot
刃	pzd
羹	ixk
颐	ety
柿	spz
烨	xmu
礁	urx
穗	wtn
郡	oaf
沐	osm
翰	udn
卑	gus
癸	tmt
箍	khz
郊	fhf
闰	evw
噌	jvd
贩	qwr
啄	jrz
鳄	zde
庐	xzh
芸	bty
苹	bks
虏	xil
魁	gol
聋	zfe
鳖	wlz
齁	dbs
鲨	ohz
冶	foj
拘	hsj
炝	xkc
纠	ycj
锯	tnx
寰	lcy
彬	cis
恳	mnx
柄	ser
讹	imw
叛	shr
沽	oxg
笃	krm
糜	xcd
俭	mgd
匡	avw
憾	nin
概	smc
荐	buu
铰	tfh
哏	jmg
濯	onr
疲	uzp
鄂	def
署	cae
偈	mdp
痔	uws
瞬	fia
呷	jgj
垒	ooa
描	hbb
拇	hnm
桐	sgm
浣	olk
溃	ocq
酌	zfz
囡	ggn
沼	oma
薜	bnf
鸠	mzn
戾	zpq
蜗	cjr
裴	pyi
亩	pbt
噪	jjs
埸	adi
袍	lfo
咂	jaz
姣	gfh
翟	nru
惧	nkt
炯	xgj
狱	pip
笙	kns
陋	fnp
涯	owv
渍	one
簋	kmc
谛	ikz
伽	mij
闸	egj
孜	ulx
馁	wag
啖	jxx
墅	mca
拈	hla
掘	hng
澍	opu
腕	vlc
酬	zdg
屑	ndv
戊	iuu
滞	oyz
嘈	jyd
垣	aeb
析	slj
虱	wac
濑	opq
睬	fic
钮	twa
鸥	ahz
鼬	ygy
禀	pdl
菡	bwg
讷	irn
雏	qor
履	nkl
蚺	cga
巅	ent
歆	snq
烛	xcc
匝	azj
澈	otl
灏	oxt
烹	ctx
犟	ijf
磡	uoi
陕	fms
姝	gap
痧	uoa
芹	blj
谗	izf
鞍	zlg
涠	ogh
炳	xer
羲	iwq
铬	tog
吠	jpq
夭	mtt
寐	lyp
昔	udr
菱	bal
藩	qib
饥	wbj
仆	mhb
坯	aje
悉	inx
拄	hzv
薯	bca
锺	txm
侨	mmn
悌	nsq
韧	hpz
梢	sdv
哺	jtf
氨	tlg
顽	tkt
亥	phh
壬	vww
戌	iei
殴	aht
簿	kou
棣	sxi
爵	acu
脐	vcn
苇	bhw
钳	tyg
鸦	azn
俚	mml
瓢	ula
秆	wkg
诵	ioe
轿	pmn
叩	jcj
摧	her
洙	oap
胤	kyv
脊	ffv
萼	bde
虞	xjm
澄	ota
萄	bfb
衍	pos
挞	hko
蔓	bqm
斧	thl
祇	lyv
稚	wru
粟	udm
絮	gjy
霆	rvo
尻	nmj
疮	ukc
吮	jok
孑	tei
甸	fbt
膈	vug
夷	kig
幢	zkm
旨	wdr
碇	ulh
溏	oxj
颊	mst
驹	rsj
嘬	jdr
循	kwf
浒	oiu
硌	uog
蚁	czh
馕	wfy
榴	syb
檐	sqi
缅	ytm
唆	jol
孬	jgu
琛	vcs
疹	uki
碜	uoi
芥	bkn
驳	rhh
踮	exl
钝	tej
钛	tkz
鹭	eoz
屿	eee
拢	hzl
撵	hmp
擀	huk
燮	ixr
筝	kqx
靶	zob
饬	wti
侍	mws
厦	wtl
溺	oif
烩	xkt
逑	iod
厘	wml
涕	osq
熨	nlx
磐	ltu
旷	dxg
梆	sqf
谐	ixn
攥	hky
歧	jur
苞	bfo
捻	hrn
疣	udy
苓	brl
枭	zsm
梭	sol
濮	omz
瞳	fkm
谴	ico
豫	czx
乞	twi
皖	nlk
糠	dxi
釉	igy
况	fjk
庵	xku
睛	fqv
窘	roj
喧	jlb
棠	djs
粿	dbs
衡	pzk
硝	udv
蚀	wcc
嵌	eyn
泾	ore
渠	oas
漱	opn
琉	vtg
祈	llj
肋	vil
钠	trn
鬟	icy
啫	jae
碉	ugq
捯	hgp
枢	sah
樽	szu
绫	yal
茗	bxj
藉	btd
谊	ilk
晤	dvj
驿	rrh
勘	owi
卟	jhb
睹	fae
肽	vkz
芃	bbz
菅	bld
诡	iqc
嗬	jbx
垛	abs
娥	ghq
庹	xuz
涧	oed
苟	bsj
驶	rjh
伢	may
匙	dhw
啐	jpu
嘶	jol
笠	kkl
谂	irn
圃	gtf
襟	lcl
泵	uis
洇	ogk
赃	qxa
陡	fdo
咣	jdl
抻	hds
汞	eis
碱	uim
绥	yag
舜	ixa
萦	yys
颌	gty
堇	zte
粼	dxg
缀	yrr
诫	iqb
锌	tfx
冀	ywt
擎	bsh
橱	swu
倏	mlp
剽	ulp
巩	ebz
氟	tin
滢	oyl
琅	vzm
禧	lpj
丈	ehi
哧	jan
嫣	gbx
胥	hvy
沧	okc
孵	yau
濠	ocr
诃	ixk
韬	hay
彰	sui
惑	qmn
歹	xdd
耿	fxh
凿	nig
廋	xyr
沸	oin
瀑	odi
煸	xzy
脯	vtf
裔	ygj
媳	gdn
暨	mcb
棺	sld
煽	xzn
罔	gsp
跷	eql
黍	wki
卅	bcc
椎	sru
胗	vki
蚕	mcc
蛛	cap
螈	cwh
汾	otp
沥	owi
窖	rfj
徨	knv
湉	onf
牟	ofn
疫	uts
坍	agp
甫	tff
缰	yee
铸	tqu
敛	gdl
沂	olj
粱	opd
酶	ztn
岫	egy
杳	sdr
泠	orl
荔	bii
藓	bzi
锈	twv
氓	pbm
璧	njl
骤	rfi
鳞	zda
壕	acr
搀	hzf
氮	txx
窟	rng
箕	koq
舀	ayj
括	hfs
炙	vxh
砣	ulw
纺	yyf
绩	yne
酣	zyg
鳓	zzi
哐	jav
唧	jmc
址	aji
屙	nfx
役	kts
晗	drj
楹	svc
衩	lrz
褒	yms
锉	tka
鼯	yvj
嗣	jym
嚄	jbr
擅	hpb
淼	iii
璞	vnz
盅	rcm
褚	lae
躯	gah
掴	hgl
炅	dxh
秧	wgk
簪	kcd
胧	vzl
胰	vki
艋	luc
菖	bdd
蕴	byc
樟	ssu
磷	uda
肢	vur
艮	mgg
咛	jlr
睽	ftm
祺	loq
镕	tlc
嫉	guv
帧	zhq
炆	xcw
炊	xnq
狷	pjv
眸	fof
赎	quk
顷	wty
咝	jyy
懿	fan
氯	toi
呔	jkz
拭	hqe
珉	vbm
瘆	uoi
肱	vuo
莞	blk
蚶	cyg
讳	ihw
豚	vrs
酯	zwd
镯	tcc
叟	ycr
蛰	hmc
倭	mwg
唾	jxt
枞	skk
栾	qsm
毗	bxb
涝	oyi
玖	vqz
薰	bxs
钾	tgj
唑	jka
峡	ems
橹	szd
瓮	tom
窍	ree
迦	ijo
鬓	ilt
侣	mjj
栎	syh
棘	nnb
瞻	fqi
络	yog
噫	jsn
妲	gbd
臻	gqw
仄	wkr
娑	ohg
敝	wlx
殊	xap
甬	oey
褶	lnn
辜	xfx
霏	rpf
兀	luu
厥	wsn
嘲	juv
檫	sll
毡	ela
涡	ojr
冢	crz
玥	vvy
瞥	wlf
硪	uhq
剔	dfp
婕	gxh
巍	ewo
械	sqb
焊	xdk
祠	lwm
莽	bpb
萃	bpu
蜷	cmc
赟	ceq
嗟	jie
嘱	jnr
峥	eqx
耄	awe
膳	vij
逄	lao
醍	zdh
铢	tap
峦	qes
抑	hyc
晔	dmu
瑰	vgo
碌	uoi
箫	kxt
胚	vje
蘼	bxp
谟	ilm
轧	pwe
鸢	qzn
黔	srw
挎	hke
箩	kcx
蚂	crm
鄣	suf
俑	moe
汰	okz
琥	vxb
谅	ich
闽	ecc
饵	wfe
驮	rkd
鲤	zml
嗄	jtl
埂	apg
尧	qlu
恻	nqp
笫	kqk
凄	fxg
凋	fgq
尬	dkn
藻	qjs
饽	wfu
厢	wsf
攘	hyw
朔	sjv
箸	kae
粹	dpu
镖	tul
惴	neh
昵	dnw
汹	ohg
淤	oyf
绾	yld
荚	bms
衔	ptj
俪	mev
倡	mdd
咀	jkq
哓	jql
嘁	jih
寓	lbr
拗	hyi
搔	hrc
撰	hot
桦	smu
湮	oua
笺	keq
胞	vfo
赣	suq
婧	gqv
嬉	gpj
庶	xux
憎	nvd
萋	bxg
蟑	csu
蹋	edn
革	zgg
伎	mur
埵	axt
孚	aui
挈	qph
狭	pms
簇	kyv
腱	vxo
蚤	rzc
黯	ssy
夯	kil
宛	lxc
怔	nbe
榈	sej
灼	xfz
瞠	fda
祯	lhq
绚	yfd
褂	lvh
昙	dty
毓	tng
沏	ovp
渭	obv
睾	aci
耒	tsm
聆	frl
膀	vky
蕙	btn
霁	rcn
涸	ogx
燎	xkh
篓	kdg
缚	ytu
胺	vlg
銮	qtj
掳	hxi
泫	opy
灞	orv
矜	crw
筠	kaf
胱	vdl
腩	vui
苡	bwk
裘	iyi
咎	lhj
姗	gyc
廓	xcf
抿	hbm
晟	diw
桀	xas
琐	vdq
眩	fpy
砚	uej
秾	wcy
绢	yjv
迢	mod
迩	qho
酪	zog
铐	tae
镰	txn
寮	lkh
愉	ngp
沱	olw
浜	olt
菁	bqv
毋	nuu
熠	xnn
熵	xkj
熹	pjx
筱	kml
蟾	cqi
衷	yro
洼	ovg
秽	wex
稽	wdd
赦	anl
佘	kls
匣	agj
婢	ggu
斐	pcw
殉	xfd
浔	oou
濂	oxn
狙	pkq
筷	knk
腓	vpf
蛀	czv
蹿	err
飒	kbh
髂	dlo
剐	jrp
匾	azy
妒	gzh
怵	nsz
焐	xvj
痂	uij
硼	uvv
祢	lqh
芷	bji
辖	plj
逞	jvo
锕	tfx
冕	dzk
呓	jbw
宙	lgy
岌	erj
幌	zdl
糍	dsy
茸	bfe
蝇	cju
侉	mke
嫔	glt
戆	sun
敖	qpl
槛	spc
俘	mau
垚	aaa
庾	xyk
晦	dtn
樯	sad
纨	ymz
苛	bxk
蓓	bmj
蔷	bad
蠃	pjc
迭	amo
际	fls
焰	xqy
璃	vpr
蕨	bwn
蛎	cwp
铞	tjz
颅	hnt
鱿	zdy
冽	fxp
啕	jfb
碴	usb
蔼	bip
谬	ini
锰	tuc
姘	gsc
悄	ndv
柠	slr
膻	vpb
诞	iao
鄙	juf
鞠	zfd
骟	rzn
髓	duo
侦	mhq
吁	jeu
呤	jrl
瓤	yda
磋	uie
糁	doi
谔	ide
铉	tpy
镌	trv
乓	lez
佗	mlw
唵	jku
嗫	jfr
囔	jfy
弼	iui
猾	pdg
碚	ukj
芡	bnq
苷	byg
麓	cal
昇	dab
竭	kdp
舛	xay
铎	trh
亢	pbj
寞	llm
扼	hwc
搋	hwb
淞	oso
甯	lne
苕	bma
葆	bms
蚌	cqf
辙	ptl
醺	zxs
钊	tpd
柒	ovs
渚	oae
肇	zlx
薏	bsn
覃	udu
跺	ebs
氛	ttp
沛	onc
猩	pdn
绗	ypx
谚	iki
阙	esn
唛	jql
峤	emn
构	sfo
樨	snf
漕	oyd
澹	oqi
羔	ixh
蒿	bcg
姥	gaw
旬	fdr
缈	yfa
谀	iyk
驯	rgc
龇	ajw
婿	ghv
曳	dwa
漩	oyh
绯	ypf
霓	ryk
靳	zlj
骜	qpr
髋	dle
喋	jus
噬	jkk
扉	zpf
湛	oow
炽	xjt
爰	aer
犁	wpf
篡	kfo
肓	pvy
躬	gig
亟	tje
冏	gtj
剌	ppd
唳	jzp
恪	nog
枷	sij
焱	xxx
诀	iak
锂	tml
卞	phb
彧	qim
惩	kbn
耷	kfe
垠	amg
愕	nde
瑄	vlb
祁	lfe
祎	lhw
绰	yhu
阀	emq
龌	ang
宓	lna
札	swe
杈	srz
栈	seq
槐	sgo
殃	xgk
氦	tph
芍	bfz
蛾	chq
誊	miy
骇	rph
缆	ype
蝗	cnv
跄	ekc
踉	ezm
镣	tkh
飨	yws
鲞	mzv
傣	mqi
凛	fpl
卉	ubc
幡	zib
廿	unn
悼	nhu
撷	hqt
擂	hrb
桷	sqj
蜇	hlc
蹉	eie
蹼	enz
镀	txr
偎	mby
哞	jof
漪	opx
笳	kij
膛	vda
诳	ipv
骡	rby
鳌	qpz
鼋	tku
侄	mgi
咤	jlv
悯	nec
捌	hjp
涤	ols
稗	wgu
宦	lec
帜	zjt
惕	ndi
掠	hch
曜	dnr
琏	vpo
蛭	cgi
酚	ztp
呒	jcu
嵘	eys
忿	tpn
恍	ndl
捺	hkl
揸	hsb
汶	ocw
洽	ogh
涣	oqk
矶	ubj
臊	vjs
钚	tjb
僻	mnf
儆	mbl
愧	ngo
敞	djl
榻	sdn
槿	szt
涟	opo
鄱	ibf
鹜	clz
殡	xlt
溥	otu
羁	czr
荧	yxh
葩	bno
仃	mrd
偕	mxn
哂	jux
唁	jiy
惮	nvu
扈	zjo
攸	mlx
桨	yxs
绔	yke
肆	ixv
莰	ban
袒	lbd
锄	tki
霰	rul
侗	mgm
嬷	gxo
帛	nzj
戮	nkq
漠	olm
狡	pfh
缳	ycy
莳	bdu
跤	efh
邑	job
锃	tjv
饴	woj
鳝	zij
噼	jnf
垃	akl
掣	fzh
簧	kug
胫	vre
腋	vpl
赭	ana
踵	exm
邰	ojf
噤	jcl
姊	gqk
庥	xms
昼	nzb
柑	syg
渥	ong
湜	odh
炷	xzv
狲	puh
矩	vaa
绽	ylh
罡	cbe
诓	iav
遢	dno
吝	cjk
哝	jcy
囫	gfi
囵	gkw
宸	lzc
怼	run
椿	sqd
樾	sdi
氰	tqv
泸	ohn
洺	oxj
牒	yus
猹	psb
筏	kmq
苋	bej
衿	lrw
讪	ies
趸	epe
唏	jhz
壤	ayw
楣	snf
澎	opi
牡	fat
瘩	ubg
谶	ike
锵	tyu
隼	rus
凰	bnv
堑	pla
弛	idy
暧	dir
槌	sao
烁	xyh
煦	dsx
瑷	vir
璟	vxj
粢	fnd
菩	bkj
谏	ips
辐	pmb
钼	tfm
锝	tbu
锹	twx
阚	ewl
伲	mnw
埠	aau
萁	boq
葭	bnr
蓖	bsx
衮	yto
骸	dph
鹃	jvz
鹫	chz
仝	keg
俳	mpf
啮	jac
嗌	jsc
嘹	jkh
嵊	eww
徊	kdh
掼	hnq
揩	hxn
檬	syr
沌	oej
焯	xhu
缎	yht
跎	elw
铡	tqp
麂	abj
厩	wmc
墟	axn
惺	ndn
撼	hin
洵	ofd
腆	vyt
赊	qkl
踝	ebs
钣	twr
铠	tea
鹳	bdz
冗	cbj
吏	mhi
屉	nuw
帚	ocz
悱	npf
昀	dff
昶	zid
朽	sek
梧	svj
汛	owu
沦	okw
洱	ofe
犀	nif
畸	bkx
疽	ukq
祉	lji
笤	kma
粲	xrd
藜	bwi
鞑	zko
韭	pei
颉	qty
髌	dlt
惬	nas
汐	oxx
爻	hhi
箔	kon
腑	vxu
蝼	cdg
阑	eps
倘	mdj
悭	npa
慑	nfr
摹	lhs
毽	exo
淮	oru
狨	pqu
瓯	ahm
祗	lyz
祷	lqu
耨	tsu
芈	bhs
褐	ldp
钴	txg
锷	tde
镚	tev
霭	rip
佶	mqj
刈	hpd
呋	jmf
怦	nks
曙	dca
涪	okj
淅	osl
珑	vzl
珺	voj
篆	kor
篑	kcq
绸	ygq
褥	lzu
诏	ima
践	eeq
踟	evj
蹰	ewu
鳐	zab
刍	qow
啜	jrr
屐	nkr
怏	ngk
懑	obn
揖	hjf
摒	hnc
檄	snl
潞	oeo
犸	prm
聿	xvv
荃	bkv
蓦	lrm
铀	tgy
铖	tiw
堰	aag
嫡	gkx
孺	urh
怠	ojn
斡	udl
旮	mdr
甪	aey
盔	uxc
紊	cys
翡	pnv
臆	vsn
蔽	bwl
蜍	ckw
劁	rxp
叱	jwb
夥	bsx
孢	ufo
惦	nxl
渎	ouk
痿	uwg
睦	faa
羌	iwe
舆	ypt
茑	bzn
蕲	bvl
诌	iqo
邕	gjo
酰	zfk
阄	equ
隙	fhh
馗	msd
髻	iqj
齉	dby
剋	xkp
匮	acq
啡	jpf
妨	gyf
姹	glv
曈	dkm
沣	oqf
熔	xlc
玹	vpy
疟	uow
疸	ubd
矍	ffr
纰	yxb
蜱	cgu
辄	pfw
鏖	atj
铄	tyh
阆	ezm
陇	fzl
陲	fxt
隶	xis
鳟	zzu
圜	gcy
幔	zqm
挟	hms
昱	dkl
疙	utw
纣	yuc
跬	evg
鞘	zdv
嗞	jsy
惭	npl
桎	sgi
梏	sfj
榭	sgu
疝	ues
硒	uux
罹	cnr
耪	tsy
薅	bgu
衅	ach
颀	lty
飏	bhi
骛	clr
黟	sxx
坷	axk
尕	vhx
峻	eol
彷	kyf
忤	ntu
戎	quy
戟	udq
掬	hfd
柘	sus
橼	syr
涐	ohq
炬	xaa
熘	xyb
玑	vbj
琶	vvo
畿	yyb
疚	uqz
砭	uab
绅	yds
莼	byj
菀	blc
跹	exo
蹁	ezy
逍	dvo
颚	det
颦	jhu
飕	bhr
鹊	udz
佯	miy
囿	guv
戕	yqg
汲	orj
涿	orz
癞	upq
眺	fkf
篷	klo
糨	dic
缉	yjf
翕	gnv
肄	wvx
芨	brj
蔗	bxx
貉	pog
趺	emf
阐	evu
雹	rfo
靛	qvh
骊	rev
骞	lwr
坳	ayi
岷	ebm
帷	zru
捩	hzp
擢	hnr
斛	qld
泗	ocs
洹	oeb
滁	ofw
猝	ppu
疖	ucj
稼	wlr
袂	lak
訇	fiy
讽	ibh
邈	pno
阖	eac
鸾	qzn
龊	aeu
倌	mld
偃	mag
凇	fso
募	lil
尢	dyy
抒	hcv
昴	dym
枳	sjt
桉	slg
楸	swx
煌	xnv
獾	pbr
眶	fav
砺	uwp
箬	kbu
缨	yqg
羿	nbc
翀	nro
诬	iek
豇	aeg
豳	err
铤	tvo
闾	ejj
韶	sma
骥	ryt
鲑	zvg
丐	ehw
哮	jau
塾	cua
尉	nlu
晌	dsj
汴	oph
珰	vdo
琢	vrz
甑	vdm
綦	oys
绪	yae
羟	ire
羸	pji
茼	bgm
豢	mrs
跚	eyc
蹒	ebk
釜	tht
亳	cav
仞	mpz
偲	mbn
劾	pil
勐	uci
哕	jex
奘	yak
崂	eyi
惘	ngp
搡	hrs
玺	qhl
瘢	ult
祕	lna
绺	ylj
耦	tsr
臼	yjj
苜	bfm
茕	ywu
荞	bmn
蓿	blu
蔬	bhg
谙	isy
遏	dfo
钡	tqb
铪	tgh
驷	rcs
麸	qlm
佣	mey
佻	mkf
剜	lxp
咨	fnj
妣	gxb
徵	kvw
悖	nfu
樵	srx
猥	pby
畀	blu
绻	ymc
缱	yco
萤	ycc
藐	bpk
衾	rwy
豺	pua
贿	quv
迤	tdo
逶	wgo
饲	wwm
黠	sqj
咆	jfo
圙	gtt
娣	gsq
彘	oww
惚	nfn
掸	hvu
攮	hfy
斟	owl
晁	dkf
橡	szx
殁	xts
浏	ocp
漳	osu
纷	ytp
臧	iec
舶	lnb
芫	btk
苣	baa
荇	bpx
荽	bag
莴	bjr
虻	cpw
诲	itn
蹚	eda
铂	tnb
馓	wul
鲎	dzv
鹀	ekz
圐	gcy
姻	ggk
娈	qgn
尴	dpc
恿	oen
溆	okr
玚	vwi
琨	vdx
璨	vxd
疱	ufo
睐	fps
祐	luy
缮	yij
胳	vog
蚜	cay
蠡	orc
觜	jwq
讴	iah
贻	qoj
跛	ezp
蹊	eak
蹙	iie
迸	sco
醛	zbv
鞅	zgk
颞	frt
龋	aar
佺	mkv
嗽	jpn
彝	odb
怆	nkc
慨	nmc
檎	skr
殖	xni
湍	oeh
獴	pyr
琯	vld
瞿	ffr
裳	djy
诙	iux
辍	prr
酵	zau
镊	tfr
麒	aoq
仟	mxq
僚	mkh
媾	gwa
孖	uui
崮	egx
巽	oot
懈	nqf
柬	psb
桠	sen
涓	ojv
焙	xkj
琰	vxx
砗	upc
磲	uos
艿	bvn
蚬	cej
襄	ydw
乸	dnm
侑	muv
剿	gbp
埔	atf
奚	ayk
岱	mqe
幛	zsu
湎	otm
潋	ogl
猡	pcx
瓴	rmw
癜	unt
盱	feu
眙	foj
祟	jgl
糅	dcs
缔	ykz
舐	fyv
茴	bdh
莒	bjj
蓑	byt
裾	lnx
谧	inc
踱	exr
遑	nvo
阪	fwr
馐	wia
骝	ryb
鹄	fjz
麾	xce
伥	mic
侪	mcn
呶	jgr
堃	yya
妤	gcv
岬	egj
峪	ecg
弋	qii
悻	nai
愠	ndc
旻	dcw
殒	xjq
沭	osz
湄	onf
滘	ocj
烽	xlq
獭	ppq
砷	uds
祼	lbs
粕	dnb
胛	vgj
胴	vgm
舷	lpy
莘	bfx
莜	bml
蕖	bos
谲	icj
醪	zni
锚	tbb
饯	weq
黢	sol
偌	mbu
吩	jtp
喙	jor
夙	bxd
峭	edv
愀	nwx
汆	kis
牦	fem
瑗	var
瘠	ufv
籁	kpq
缭	ykh
罘	cjb
翎	rnv
蒹	bsn
螳	cda
衙	pvj
袆	lhw
襦	lrh
诧	ilv
诽	ipf
谕	igp
赍	fkq
锻	tht
饕	jew
鬃	ill
鲠	zpg
鳃	zbn
倜	mgq
傥	mdk
劼	qil
婠	gld
峒	egm
崆	ere
怛	nbd
柩	saz
楔	sqk
泔	oyg
瀛	opg
爨	ygx
玦	vak
痹	ubl
睥	fgu
睨	fyk
茚	byc
蜕	cvk
谥	isc
貘	plm
邋	gyo
邳	jef
饹	wog
驽	grr
䁖	fdg
丞	wie
俎	kkk
俶	mir
峋	efd
嶙	eda
嶷	ewh
徘	kpf
栲	sae
栳	saw
皙	sln
砀	uwi
纾	ycv
绦	yls
芜	bcu
芩	brw
茫	qpw
葺	bjf
蛱	cms
贮	qle
邨	ejf
醐	zxv
铱	tyi
镲	tll
饸	wgh
驸	rmu
鹟	toz
麝	agu
黜	sjg
龅	afo
佝	msj
佼	mfh
侮	mtn
俸	mqh
偻	mdg
厍	wpc
嘌	jul
噙	jkr
嬗	gpb
岐	eur
峨	ehq
嵋	enf
忾	ntq
惇	ncu
暝	dcf
椴	sht
椹	sow
汕	oes
沆	opb
浚	ool
淦	otj
溧	ous
瀣	oxe
烯	xhz
簌	kpn
脘	vlk
腭	vde
荀	bfd
虔	xcw
蜚	pcc
蜥	csl
裢	lpo
褡	lbg
踅	hle
邸	yvf
锆	tfj
陂	fzp
魍	gop
龛	gzl
妯	ggy
娆	gql
娌	gml
弁	obc
弈	qbc
徜	kdj
榄	spe
泓	oio
涎	oao
狈	pqb
瘘	udg
瘴	usu
盂	euc
砥	uyz
硚	umn
腙	vll
荻	bpx
蔑	bcz
裨	lgu
谝	izy
赘	qpq
邝	xfe
镬	tbr
馃	wbs
骓	rru
乂	hii
伉	mpb
僭	mcd
儋	mqi
啉	jcl
垭	aen
埕	ajv
娲	gjr
嫚	gqm
孀	grf
崃	eps
桡	sql
殆	xoj
泮	osh
漯	oby
潺	onu
濒	ojt
璜	vug
疵	ujw
硐	ugm
箧	kas
绀	yyg
缶	bff
萸	byk
蒡	bky
螃	cky
觥	qdl
豉	aur
趄	dkq
趔	dxp
跐	ejw
蹴	ecd
邛	efe
锭	tlh
驭	rry
髅	ddg
鸳	xcz
仂	mil
嫪	gni
忪	nto
慷	nxi
憷	nch
摈	hlt
椽	sor
榧	sap
毐	anu
毳	eee
沓	idr
沩	ozz
淀	olh
碣	udp
缦	yqm
罄	anb
翮	unv
胬	grk
膺	xmv
蛳	cpz
贲	ubq
迂	euo
锱	tgb
镂	tdg
镉	tug
镫	tta
馄	wdx
俅	miq
叵	ajk
喱	jwm
噘	jwn
奂	qgk
妪	gah
廪	xpl
掮	hzv
旸	dwi
栊	szl
椟	suk
沤	oah
潸	ocv
烷	xlk
牯	fxg
瑙	vgh
瞑	fcf
笕	kej
绌	yjg
缛	yzu
缤	ylt
羚	irl
翌	nkl
舂	qyj
艏	lsd
蒗	qzm
蚩	jec
蛟	cfh
讼	ito
醅	zkj
钥	tvy
铳	ttk
颏	pty
馒	wqm
魇	wpo
傈	mus
僳	mud
嗐	jlj
噩	vdd
垡	mqa
壑	xca
惰	nuv
挲	ohh
旖	ytx
桢	shq
溟	ocf
滟	oqo
燔	xib
牍	yuk
犍	fxo
狍	pfo
玟	vcw
痢	uwp
缙	yed
荟	bkt
荪	buh
蒺	buv
蚰	cgy
蜒	cao
诘	iqj
谒	idp
轼	pqe
辗	pny
遐	nto
鄢	bef
钜	taa
锑	tsq
镗	tda
陨	fjq
鲛	zfh
鹞	abz
侩	mkt
僦	mcd
圩	aeu
坻	ayz
埗	ajh
忖	nuc
攫	hfr
氐	yvz
潼	okm
琇	vwv
畴	bqu
瘊	umv
眦	fjw
睚	fwv
碓	uru
笏	kfi
翊	knv
胍	vag
茉	bpm
莠	bwv
蛄	cxg
蝈	cgl
蝰	ckv
蟀	cpu
褛	ldg
褴	lpc
讥	ibj
蹩	wle
轭	pwc
遒	zod
酊	zrd
酩	zxj
醨	zpr
隈	fby
隘	fsc
雎	kru
鳗	zqm
鹾	lhe
咥	jgi
哌	jwy
嗵	joo
埤	agu
嫫	glm
愎	ntl
戗	kcq
敕	plx
旌	ytn
梿	spo
棹	shu
榫	sru
泱	ogk
瘐	uyk
盎	gkc
睫	fxh
祜	lxg
稹	wnt
罂	qqb
羧	iol
肴	huv
芎	big
菂	bnz
蚴	cyi
蜈	cjm
蟠	cib
轳	phn
辘	pal
醴	zya
钕	tgn
铍	tzp
铵	tlg
锎	tec
骅	rmu
鬣	igy
仉	mbj
俵	mqy
冼	ffk
咴	jux
哙	jkt
哽	jpg
唿	jfn
喟	jbv
崛	eng
嵛	egp
憧	nkm
戋	eqg
捍	hdk
晡	dtf
枧	sej
槎	sie
歃	xyn
氘	tnd
溴	odp
煜	xdk
爿	ypp
犇	fff
犒	fcg
皴	otz
睑	fgd
瞰	fwl
稞	wbs
窸	rin
筜	kdo
筼	kjq
芣	bjb
荜	bxu
蟥	cug
衢	pfr
诤	iqx
谠	idk
蹇	lwe
酢	zra
钺	tiu
镍	tds
镓	tlr
镭	trb
隍	fnv
靥	wpt
顼	vty
颛	eht
髎	dni
鳍	zad
鸰	rzn
兢	xkk
呣	jnm
囹	grl
圄	gvj
圻	alj
垞	alv
垩	ena
埙	ajq
夔	sdl
姒	gwk
嵇	wde
弭	ife
怄	nah
悚	nps
懦	nrh
戢	jfq
拮	hqj
昉	dyf
晞	dhz
杼	scv
榉	sdh
殚	xvu
殳	tss
沅	otk
漓	opr
濡	orh
炀	xwi
炔	xak
烬	xnf
燊	xxs
猢	pxv
玘	vaj
琵	vvx
癿	nwe
眭	fvg
瞋	fnt
窿	rfn
纮	yuo
耋	awg
胩	vih
脞	vka
莆	btf
蓼	bni
蘑	bxu
蜃	zcc
袪	lao
觐	zte
诂	ixg
谡	ibl
赑	qqq
跖	eus
踞	enx
踯	esf
躅	ecc
迥	gjo
酐	zkg
钯	tob
铯	tqo
颧	bdt
馇	wsb
骺	dwm
鲔	zuv
鸮	jez
鸯	gkz
鹗	dez
鹩	ksz
黩	suk
丕	jei
乩	lwe
亘	ebd
伺	mwm
俟	mov
劢	epi
匕	wbb
呻	jds
咇	jna
喈	jxn
噱	jxr
嚏	jfh
圾	arj
奠	zkd
彳	kcc
忏	nxq
扦	hxq
扽	hej
挚	hmh
昝	lhd
晰	dsl
楫	sjf
淄	ogb
潴	opa
皋	nku
碛	une
秩	wam
稔	wrn
翩	zyn
耧	tsg
芗	byx
荠	bcn
蒐	bgo
藿	brr
蘖	bas
蝠	cmb
衽	lvw
褙	lyv
觑	xne
诅	ikq
诒	ioj
辔	ypj
鄞	ztf
醚	zdo
醯	ztc
钏	tgc
霈	roc
霹	rnf
韪	dhh
饷	wsj
骐	roq
魉	gok
鳎	zdn
鳔	zul
鸵	zlw
龈	amg
㑇	mqo
㑊	mqi
㕮	jth
㘎	jel
㙍	arr
㙘	aug
㙦	kwa
㛃	qpg
㛚	goe
㛹	gmp
㟃	ewm
㠇	ecd
㠓	eyr
㤘	nqo
㥄	nal
㧐	hrs
㧑	hzz
㧟	hoa
㫰	dzm
㬊	dar
㬎	dyx
㬚	dtl
㭎	sgh
㭕	sao
㮾	zms
㰀	swi
㳇	oth
㳘	otk
㳚	oiz
㴔	oqn
㵐	own
㶲	xey
㸆	xfp
㸌	xrr
㺄	pgp
㻬	vre
㽏	ogy
㿠	ndl
䂮	qpu
䃅	uvu
䃎	ukx
䅟	woi
䌹	ygj
䎃	gan
䎖	vdn
䏝	vtz
䏡	vls
䏲	vsq
䐃	vgw
䓖	bri
䓛	bng
䓨	ybf
䓫	bkx
䓬	bhu
䗖	cyz
䗛	cmv
䗪	xuc
䗴	cko
䜣	ilj
䝙	pah
䢺	jgf
䢼	utf
䣘	djf
䥽	tjr
䦃	tba
䲟	zyc
䲠	zqd
䲢	vmz
䴓	ezz
䴔	fhz
䴕	xpz
䴖	qvz
䴗	fpz
䴘	wxz
䴙	njz
䶮	zmt
丏	ecw
亍	kcc
亓	elu
亵	yhz
亶	pdb
亸	cuu
亹	pyk
仡	mtw
仫	mao
仳	mxb
仵	mtu
伈	mnx
伋	mrj
伛	mah
伣	mej
伧	mkc
伫	mle
伭	mpy
伾	mje
佁	moj
佃	mbt
佖	mna
佚	mam
佞	mtg
佤	mmw
佥	gdd
佴	mfe
佸	mfs
佽	mfn
佾	mtv
侁	mfk
侂	mxv
侈	mxx
侏	map
侔	mof
侘	mlv
侥	mql
侴	gwp
侹	mvo
俍	mzm
俙	mhz
俜	mge
俣	mjm
俦	mqu
俨	mew
俫	mps
倓	mxx
倕	mxt
倞	mch
倥	mre
倧	mll
倨	mnx
倬	mhu
倮	mbs
倴	mkb
倻	mff
偁	maa
偓	mng
偡	mow
偬	mfn
偭	mtm
偰	mqk
偾	muq
傀	mgo
傃	mqy
傉	mzu
傒	mak
傕	mcr
傧	mlt
傩	mrr
傺	mtl
僇	mni
僎	mot
僔	mzu
僖	mpj
僬	mrx
僮	mkm
僰	nnk
儇	mcy
儡	mbb
儦	max
儳	mzz
儴	myw
兕	glu
兖	fok
冁	vuy
冔	dju
冮	feg
冱	feo
凓	fus
凘	fol
凫	zbj
凼	igk
刎	fip
刖	vpd
刬	eqp
刭	rep
刳	kep
刽	ktp
刿	exp
剀	eap
剅	apd
剕	ppd
剞	kxp
剟	rrp
剡	xxp
劂	wsp
劄	kgp
劐	brp
劓	dbp
劬	sil
劭	mil
勍	chi
勔	til
勖	dfi
勚	uwi
勠	nki
勰	iin
匆	fiz
匈	fhg
匍	ftf
匏	keo
匐	fmb
匜	ady
匦	apm
匼	agh
卣	lak
卬	ycj
卮	wec
卺	wic
厖	wui
厣	wpg
厾	wao
叆	tir
叇	txo
叕	rrs
叚	ntr
吣	jnx
吲	jic
呇	ijk
呖	jwi
呙	jrn
咄	jjg
咉	jgk
咍	joj
咐	jmu
咙	jzl
咡	jfe
咫	nzt
咺	jeb
哃	jgm
哚	jbs
哢	jvb
哱	jfu
哳	jhl
哿	ijx
唝	jeq
唢	jdq
唣	jnv
唪	jqh
唼	jkg
啁	jgq
啬	asd
啭	jpz
啴	jvu
啶	jlh
啻	kzj
喁	jbr
喑	jsy
喤	jnv
喹	jkv
喾	dfj
嗉	jqy
嗍	jsv
嗥	jnu
嗪	jqw
嗾	jyv
嘏	xnr
嘡	jda
嘧	jle
噀	jot
噂	jzu
噇	jkm
噍	jrx
嚅	jrh
嚆	jbc
嚚	ded
嚭	pjj
囟	shi
囱	slx
囷	gwh
圉	gai
圊	gqv
圌	geh
圢	ard
圪	atw
圫	aav
圬	aee
圮	aaj
圯	aos
圲	axq
圳	agc
圹	axg
坉	aej
坋	atp
坌	tpa
坒	xat
坜	awi
坥	akq
坩	ayg
坫	ala
坬	aag
坭	anw
坰	agj
坼	alz
坽	arl
垄	zat
垆	ahn
垈	mqa
垌	agm
垍	adi
垎	aog
垏	axv
垓	aph
垕	wma
垙	adl
垟	aiy
垤	agi
垧	asj
垯	ako
垱	ado
垲	aea
垴	apg
垸	alk
垺	aau
垾	adk
垿	axc
埆	aqj
埇	aoe
埌	azm
埏	aao
埒	aau
埘	adu
埚	ajr
埝	arn
埪	are
埫	adj
埭	axi
埯	aku
埴	ani
埼	akx
埽	aoz
堉	atv
堋	avv
堌	agx
堍	azz
堎	aal
堐	awv
堙	aua
堞	aus
堠	amv
堧	ahk
堨	adp
堲	mca
堼	vua
堽	acb
堾	aqd
塄	acy
塅	aht
塆	aqi
塍	vma
塝	aky
塥	aug
塬	awh
塱	zma
墀	anf
墁	aqm
墈	aoi
墉	axe
墐	azt
墒	akj
墕	abx
墘	auw
墚	aos
墡	aij
墣	anz
墦	aib
墼	pga
壅	pya
壸	fen
夐	qgl
夤	xlg
夬	akr
夼	kgc
奁	kah
奄	kud
奓	kxx
奡	tkn
奭	kuu
妁	gfz
妊	gvw
妗	grw
妘	gty
妧	gtk
妩	gcu
妫	gzz
妭	gur
姈	grl
姞	gqj
姤	gwm
姮	geb
姱	gke
姶	ggh
姽	gqc
娀	gqu
娉	gge
娓	gne
娠	gzc
娩	gzk
娵	gfr
婀	gfx
婌	gir
婍	gkx
婘	gmc
婞	gai
婤	ggq
婪	cgn
婫	gdx
婳	geg
婺	clg
婻	gui
婼	gbu
媂	gkz
媄	gik
媆	ghk
媓	gnv
媖	gbk
媞	gdh
媪	gdc
媭	itg
媱	gab
媲	gsx
媵	vmg
媸	gjc
嫄	gwh
嫒	gir
嫕	gan
嫘	gby
嫜	gsu
嫠	plg
嫭	gxu
嫱	gad
嫽	gkh
嬖	njg
嬥	gnr
嬬	grh
嬿	gux
孅	gke
孓	tzd
孛	fui
孥	gru
孪	qui
孱	nuu
孳	syu
宄	lmj
宕	lus
宧	lec
宬	liw
寁	lxh
寤	lyj
寥	lni
尜	hkh
尥	dfz
尨	uwi
尪	dvw
屃	nqb
屣	nkh
屦	nkg
屺	eaj
屼	elu
屾	ees
岈	eay
岊	oes
岍	eck
岖	eah
岘	eej
岙	mes
岜	eob
岞	era
岠	eaa
岢	exk
岣	esj
岨	ekq
岵	exg
岽	evh
岿	epo
峁	eym
峂	elf
峃	des
峄	erh
峗	eqc
峘	eeb
峙	ews
峛	exp
峣	eql
峧	efh
峱	pwe
峿	evj
崀	ezm
崁	ean
崄	egd
崌	enx
崒	epu
崚	eal
崞	ecu
崟	etj
崡	ewg
崤	ehv
崦	eku
崧	eso
崭	epl
崶	evu
崾	eug
崿	ede
嵁	eow
嵅	eim
嵎	ebr
嵖	esb
嵚	etn
嵝	edg
嵫	esy
嵬	ego
嵯	eie
嵲	eds
嵴	efv
嶂	esu
嶅	qpe
嶍	enn
嶒	evd
嶓	eib
嶝	eta
嶟	ezu
嶦	eqi
嶲	erg
巇	exq
巉	ezz
巯	reg
帏	zhw
帑	grz
帔	zzp
帙	zam
帡	zsc
帨	zvk
帱	zqu
帻	zne
帼	zgl
幄	zng
幖	zul
幞	znz
幪	zyr
庋	xur
庑	xcu
庖	xfo
庠	xiy
庤	xws
庱	xal
庳	xgu
庼	xwt
廆	xgo
廑	xzt
廒	xql
廙	xbt
廛	xma
廨	xqf
弆	aob
弇	gbc
弑	hse
弢	ijr
弨	ima
弶	ich
弸	ivv
彀	fei
彖	ors
彗	qqo
彟	our
徂	kkq
徇	kfd
徉	kiy
徙	kjh
徛	kkx
徭	kab
徼	knl
忉	npd
忐	inx
忑	ehn
忝	mhx
忞	cnx
忡	nro
忭	nph
忮	nur
忱	nck
忳	nej
忸	nwa
忺	nnq
怃	ncu
怅	nic
怊	nma
怍	nra
怙	nxg
怩	nnw
怫	nin
怿	nrh
恂	nfd
恓	nux
恔	nfh
恙	inx
恚	vnx
恝	qpn
恣	fnn
恧	hnx
恫	ngm
恸	nti
恹	nwp
恽	ncp
悃	ngs
悆	kwn
悈	nqb
悒	njo
悛	nol
悝	nml
悢	nzm
悫	fbn
悰	nll
悴	npu
悸	nwu
惆	ngq
惋	nlc
惎	onx
惔	nxx
惙	nrr
惛	nyd
惝	ndj
惫	lbn
愃	nlb
愆	pon
愍	bln
愐	ntm
愔	nsy
愦	ncq
愫	nqy
愭	nad
慆	nay
慊	nsn
慝	abn
慥	nfo
慬	nzt
慭	psn
慵	nxe
憔	nrx
憕	nta
憙	pjn
憩	fdn
憬	nxj
憭	nkh
憺	nqi
懊	nsk
懋	scn
懔	npl
戍	izd
戛	tqg
戡	owq
戣	tmq
戤	vrq
戥	dnq
戬	enq
戭	leq
戽	zld
扂	zla
扃	zgj
扅	zxx
扆	zyi
扊	zxx
扞	hkg
扪	hem
扺	hyv
抃	hph
抉	hak
抔	hjb
抟	htz
抨	hks
拃	hra
拊	hmu
拤	hih
拯	hwe
拶	hgx
挓	hlv
挛	qhs
挝	huo
挦	hou
挹	hjo
捃	hoj
捭	hgu
捽	hpu
掇	hrr
掊	hkj
掎	hkx
掞	hxx
掭	hmh
掾	hor
揄	hgp
揆	htm
揕	how
揠	hag
揳	hqk
揶	hff
揿	htn
搌	hny
搐	hpb
搒	hky
搛	hsn
搠	hsv
搦	hif
搪	hxj
搴	lwh
摅	hxn
摏	hqy
摛	hpr
摭	hxx
摴	hre
摽	hul
撄	hqg
撖	hwl
撙	hzu
撺	hrr
擐	hcy
擘	njh
擞	hdl
擿	hko
攉	hrr
攽	tpl
敉	dlx
敔	vjl
敩	dul
敫	nyl
斓	ces
斝	dcl
斠	wgl
斫	ulj
斶	lcc
旃	ytp
旄	yte
旆	ytc
旎	ytw
旐	ytf
旒	ytg
旞	yto
旯	dmj
旰	dkg
旴	deu
旵	des
旿	dtu
昃	dwk
昄	dwr
昈	dzh
昒	dfi
昡	dpy
昣	dki
昤	drl
昪	dob
昫	dsj
昳	dam
昺	der
昽	dzl
晅	deb
晊	dgi
晐	dph
晙	dol
晢	hld
晪	dyt
晫	dhu
晱	dxx
晷	dlj
暅	dnb
暌	dtm
暕	dps
暲	dsu
暵	duk
暶	dyh
暹	dro
暾	dcl
暿	dpj
曌	dve
曛	dxs
曩	dyw
曷	dfp
朏	vjg
朐	vsj
朓	vkf
朳	stb
朸	sil
杄	sxq
杌	slu
杓	sfz
杕	skd
杙	sqi
杞	saj
杧	spw
杩	srm
杪	sha
杲	dsm
杷	sob
杻	swa
枅	sck
枇	sxb
枋	syf
枍	ste
枘	srn
枥	swi
枨	sic
枲	ojs
枵	sje
枸	ssj
枹	sfo
柁	slw
柃	srl
柈	ssh
柊	slf
柖	sma
柙	sgj
柝	slz
柞	sra
柢	syz
柰	sls
柷	sjk
柽	sra
栀	swc
栉	sbc
栌	shn
栐	szi
栒	sfd
栝	sfs
栟	ssc
栩	snv
栴	stp
栻	sqe
桁	spx
桄	sdl
桅	sqc
桊	msm
桕	syj
桤	sea
桧	skt
桫	soa
桯	sjv
桲	sfu
桴	sau
桹	szm
梃	svo
梌	skw
梠	sjj
梣	sew
梴	sao
梼	squ
梽	san
梾	sps
棁	svk
棂	sox
棐	psm
棓	skj
棤	sud
棨	zls
棪	sxx
棫	sqm
棬	smc
棰	sxt
棻	bts
棼	ctp
棽	crw
椀	slc
椁	scu
椆	sgq
椋	sch
椐	snx
椑	sgu
椓	srz
椠	pls
椤	scx
椪	ssn
椭	sfv
椸	syd
楂	ssb
楒	sbn
楗	sxo
楙	scs
楝	sps
楦	slb
楩	smp
楪	sus
楮	sae
楯	swf
榃	cbt
榅	sdc
榇	sks
榍	snv
榑	stu
榔	szf
榖	fes
榰	sad
榱	syt
榷	scr
槁	scg
槃	lts
槊	sjs
槔	snu
槚	suq
槜	srv
槠	sia
槭	sih
槱	szx
槲	sql
樗	sre
樘	sda
橄	swl
橇	see
橐	fus
橑	skh
橛	swn
橞	stn
橥	pas
橦	skm
檑	srb
檗	njs
檞	sqf
檠	bss
檩	spl
櫆	sgl
欂	squ
欤	ewn
欹	kxn
欻	xxn
歅	uan
歙	gnn
殂	xkq
殄	xki
殍	xau
殓	xgd
殛	xte
殣	xzt
殪	xfa
毂	fpc
毌	ngg
毖	xna
毪	eof
毵	oke
毹	gve
氅	dje
氆	esd
氇	ezd
氍	ffe
氕	tap
氖	tvn
氙	tes
氚	tgc
氡	tlf
氤	tgk
氩	ten
氲	tdc
氾	ocj
氿	omj
汈	owe
汊	orz
汋	ofz
汔	otw
汜	oos
汧	ock
汨	odr
汩	odr
汫	owj
汭	orn
沄	oty
沇	ook
沔	oew
沘	oxb
沚	oji
沨	obh
沮	okq
沺	obt
泂	ogj
泃	osj
泅	ogk
泇	oij
泐	ofi
泖	oym
泙	oks
泚	ojw
泜	oyz
泞	olr
泺	oyh
洄	odh
洈	oqc
洌	oxp
洎	odi
洑	omp
洓	onb
洘	oae
洚	ola
洢	oma
洣	odm
洧	ouv
洨	ofh
洫	oac
洭	oav
洮	okf
洳	ogj
洴	osc
洸	odl
洿	oke
浃	oms
浈	ohq
浉	opz
浍	okt
浐	okw
浕	onf
浛	orj
浞	oeu
浟	oml
浠	ohz
浡	ofu
浥	ojo
浬	oml
浭	opg
浯	ovj
浰	owp
浲	olq
浼	ozk
涄	oge
涍	oau
涑	ops
涔	oew
涘	oov
涞	ops
涢	ojq
涫	old
涴	olc
淆	ohv
淏	odm
淖	ohu
淙	oll
淜	ovv
淝	ovo
淟	oyt
淠	obl
淬	opu
淯	otv
淴	ofn
渌	ooi
渑	oju
渟	ocr
渫	ous
渰	ogb
渲	olb
渼	oik
湃	ohq
湑	ohv
湓	otc
湔	osp
湝	oxn
湟	onv
湣	obd
湫	owx
湲	oar
湴	osn
溁	oys
溇	odg
溉	omc
溍	oed
溘	oac
溚	obg
溞	orc
溠	oie
溦	oel
溱	oqw
溲	oyr
溵	owt
溷	ogr
溹	ofy
溻	odn
溽	ozu
滂	oky
滃	otn
滆	oug
滉	odl
滍	ojc
滏	ott
滓	olf
滔	oay
滗	oke
滠	ofr
滦	oqs
滧	ofl
滪	oct
滫	omv
滹	oxu
漈	otl
漉	oal
漋	ofn
漖	oal
漤	ocg
漦	pli
漭	obb
漴	oel
漶	orn
漷	ocf
漹	obx
漻	oni
漼	oer
潆	oyy
潍	oyr
潏	ocj
潖	ovo
潟	oyx
潢	oug
潦	okh
潩	obt
潲	owv
潵	oul
潽	osd
潾	oda
澂	oel
澉	owl
澌	ool
澛	ozd
澥	oqf
澧	oya
澪	orr
澭	opr
澴	ocy
澶	opb
澼	onf
澽	oxr
濉	ofr
濋	och
濞	odl
濩	obr
瀌	oax
瀍	oxa
瀔	oft
瀱	ocp
瀵	odt
瀹	ogy
瀼	oyw
灈	ofr
炌	xkn
炘	xlj
炟	xbd
炣	xxk
炱	ojx
炻	xus
烀	xau
烃	xre
烊	xiy
烔	xgm
烜	xeb
烝	wix
烠	xuv
烶	xvo
烺	xzm
烻	xao
焆	xjv
焌	xol
焓	xrj
焘	qux
焜	xdx
焞	xcu
煁	xow
煃	xkv
煅	xht
煊	xlb
煋	xdn
煓	xeh
煟	xbv
煳	xxv
煴	xdc
煺	xmo
熇	xcg
熛	xul
熜	xsn
熥	xoo
熻	xgn
燋	xrx
燏	xcj
燚	xxx
燠	xsk
燧	xso
燹	rrx
爇	bax
爔	xiq
爚	xgy
爝	xau
爟	xbr
牁	yxk
牂	yiy
牖	yzt
牚	dja
牝	fwb
牤	fpw
牥	fyf
牮	mqf
牺	fux
牻	fui
牾	fvj
牿	ffj
犄	fkx
犋	fkt
犏	fzy
犨	rrf
犰	pmj
犴	pkg
犷	pxg
狁	pok
狃	pwa
狉	pje
狎	pgj
狒	pin
狝	pqh
狞	plr
狩	plu
狯	pkt
狰	pqx
狳	pkw
狴	pxa
狺	piy
狻	pol
猁	pwp
猃	pgd
猄	pch
猇	pxb
猊	pyk
猕	pih
猖	pdd
猗	pkx
猞	pkf
猬	pbv
猯	peh
猰	pqk
猱	pcs
猷	zpq
猺	pab
獍	psk
獐	psu
獗	pwn
獠	pkh
獬	pqf
獯	pxs
玃	pfr
玎	vrd
玒	veg
玓	vfz
玕	vkg
玙	vee
玞	vmf
玠	vkn
玡	vay
玢	vtp
玤	vqf
玭	vxb
玱	vkc
玳	vmq
玶	vks
玷	vla
玼	vjw
玿	vma
珅	vds
珇	vkq
珋	vym
珌	vna
珏	vlv
珐	vao
珒	vxv
珕	vii
珖	vdl
珙	vut
珛	vuv
珝	vnv
珢	vmg
珣	vfd
珥	vfe
珦	vsj
珧	vkf
珩	vpx
珪	vvg
珫	vtk
珲	vcp
珵	vjv
珷	vej
珸	vvj
珹	viw
珽	vvo
琀	vrj
琄	vjv
琈	vau
琊	vaf
琎	vwo
琔	vlh
琚	vnx
琟	vru
琡	vir
琤	vqx
琫	vqh
琬	vlc
琭	voi
琮	vll
琲	vpf
瑀	var
瑁	vdf
瑂	vnf
瑃	vqd
瑅	vdh
瑆	vdn
瑑	vor
瑓	vps
瑔	vni
瑖	vht
瑚	vxv
瑝	vnv
瑢	vlc
瑧	vqw
瑨	ved
瑬	otl
瑭	vxj
瑱	vnt
瑳	vie
璀	ver
璁	vsn
璆	vni
璈	vql
璋	vsu
璎	vqg
璒	vta
璘	vda
璠	vib
璥	vbl
璩	vxr
璪	vjs
璬	vnl
璮	vpb
璱	vva
璲	vso
璺	ygl
瓀	vrh
瓒	vfq
瓖	vyw
瓘	vbr
瓞	aam
瓠	kea
瓻	hum
瓿	kjm
甍	bcm
甏	pim
甓	njm
甗	xum
甡	nns
甥	nbi
甦	pns
甾	gbt
畈	bwr
畋	blx
畎	bpq
畖	bag
畚	okb
畛	bki
畤	bws
畦	bvg
畬	kwb
畯	bol
畲	klb
畹	blc
疁	bni
疃	bkm
疍	hbd
疐	fbh
疔	urd
疠	uep
疡	uwi
疢	uxh
疥	ukn
疬	uwi
疭	ukk
疰	uzv
疳	uyg
疴	uxk
痃	upy
痄	ura
痈	uey
痉	ure
痊	ukv
痍	uki
痓	ugi
痤	uka
痦	uvj
痪	uqk
痫	ues
痱	upf
痼	ugx
瘁	upu
瘃	urz
瘅	uvu
瘌	upp
瘕	unr
瘗	uma
瘙	urc
瘛	uqn
瘥	uie
瘭	uul
瘰	uby
瘳	uni
瘵	utl
瘼	ulm
瘿	uqg
癀	uug
癃	ufn
癍	uvv
癔	usn
癗	urb
癯	ufr
皈	nwr
皑	nea
皕	uub
皛	nnn
皞	nnu
皤	nib
皦	nnl
皭	nau
皲	cpz
盉	wcm
盍	aoc
盥	yic
盦	rwc
盷	fff
眄	few
眇	fha
眊	fem
眍	fah
眚	nfm
眢	xcf
眬	fzl
眵	fxx
睃	fol
睄	fdv
睎	fhz
睢	fru
瞀	clf
瞌	fac
瞍	fyr
瞢	bcf
瞩	fnr
瞫	fuu
瞵	fda
瞽	puf
矞	cgj
矧	vic
矰	vvd
矸	ukg
矻	utw
矼	ueg
矾	ubz
砄	uak
砆	umf
砉	qus
砑	uay
砒	uxb
砘	uej
砜	ubh
砝	uao
砟	ura
砠	ukq
砧	ula
砫	uzv
砬	ukl
砮	gru
砵	use
砹	ubh
砻	zus
砼	uke
砾	uyh
础	ujg
硁	ure
硇	ush
硊	uqc
硍	umg
硎	ucp
硔	uut
硖	ums
硗	uql
硙	uea
硭	ubp
硿	ure
碃	uqv
碈	uyd
碏	uud
碡	uqn
碥	uzy
碨	uby
碲	ukz
碶	uqk
碹	ulb
磉	urs
磏	usn
磔	uxs
磙	uyo
磜	utl
磬	anu
磴	uta
磹	uuu
磻	uib
礅	ucl
礌	urb
礓	uee
礞	uyr
礴	uqu
礵	urf
祀	los
祃	lrm
祆	lmt
祊	lyf
祋	lts
祏	lus
祓	lur
祚	lra
祧	lkf
祲	lor
祾	lal
禊	lqk
禋	lua
禒	lor
禔	ldh
禘	lkz
禚	lix
禛	lnt
禤	lcn
禳	lyw
禺	brn
秕	wxb
秣	wpm
秫	wsz
秬	waa
秭	wqk
秸	wqj
稂	wzm
稃	wau
稆	wjj
稌	wkw
稑	waa
稙	wni
稣	zwh
稷	wbl
穄	wtl
穑	wad
穙	wnz
穜	wkm
穟	wso
穰	wyw
穸	rxx
穹	rig
窀	rej
窅	rfm
窈	ryi
窊	rag
窎	rzn
窒	rgi
窕	rkf
窠	rbs
窣	rpu
窨	rsy
窬	rgp
窭	rdg
窳	raa
竑	kuo
竘	ksj
竣	kol
竦	kps
竫	kqx
竺	kte
竽	keu
笄	kck
笆	kob
笊	kau
笞	koj
笥	kwm
笪	kbd
笮	kra
笯	kgr
笱	ksj
笸	kaj
笾	kio
筀	kvg
筅	kfk
筇	kef
筌	kkv
筘	khj
筚	kxu
筢	kho
筤	kzm
筥	kjj
筦	klk
筮	kek
筲	kdv
筵	kao
筶	kfj
筻	kpg
箅	kbl
箐	kqv
箓	koi
箖	kcl
箜	kre
箢	klc
箦	kne
箨	khh
箪	kvu
箴	kim
篁	knv
篌	kmv
篙	kcg
篚	kap
篝	kwa
篥	kus
篦	ksx
篪	kwb
篯	ktq
篼	knk
篾	kcz
簃	kwx
簉	kfo
簏	kal
簕	kzi
簖	kdl
簝	kkh
簟	kuu
簠	ktc
簰	kyu
簸	koz
籀	khb
籥	kgy
籴	kdm
籼	des
粜	jgd
粝	dwp
粞	dux
粳	dpg
糇	dmv
糈	dhv
糌	dld
糒	due
糵	bad
絜	qpy
絷	hmy
綮	zly
縠	fey
縢	vmy
縻	xcy
繄	avy
繇	aby
纂	kfy
纛	qny
纡	yeu
纥	ytw
纩	yxg
纫	ypz
纭	yty
纴	yvw
纻	yle
纼	yic
绁	yuw
绂	yur
绉	yqo
绋	yin
绎	yrh
绐	yoj
绖	ygi
绠	ypg
绡	ydv
绤	ycg
绨	ysq
绱	ydj
绲	ydx
绶	yir
绹	yfb
缂	yzg
缃	ysf
缄	yim
缊	ydc
缌	ybn
缐	yni
缑	ymv
缒	yao
缗	ybd
缜	ynt
缞	yyt
缟	ycg
缡	ypr
缢	ysc
缣	ysn
缥	yul
缧	yby
缫	ygs
缬	yqt
缯	yvd
缲	yjs
缵	yfq
罅	bxu
罍	bbb
罟	cxg
罨	cku
罱	cui
罴	cax
罶	cyb
罽	cwp
罾	cvd
羑	iqz
羓	iob
羕	izi
羖	its
羝	iyz
羰	iex
羱	iwh
羼	nii
翂	ntp
翃	uon
翈	gnv
翙	exn
翚	ncp
翛	mln
翥	anv
翦	svn
翯	ncg
翱	nkn
翳	avn
翷	dxn
翾	cmn
耆	awd
耇	asj
耏	his
耑	ehe
耔	tsu
耖	tsa
耘	tst
耜	tsd
耠	tsg
耢	tsi
耤	tsd
耥	tsj
耩	tsa
耰	tsl
耱	tsu
耵	frd
聃	fga
聍	flr
聒	ffs
聩	fcq
聱	qpf
肟	vee
肪	vyf
肫	vej
肭	vrn
肮	vpb
肷	vnq
肸	vtu
肼	vwj
胁	vit
胂	vds
胄	gvy
胈	vur
胙	vra
胝	vyz
胠	vao
胣	vtd
胨	vvh
胪	vhn
胭	vgk
胲	vph
胼	vsc
脍	vkt
脎	vhs
脒	vdm
脔	qrk
脟	vau
脩	mlv
脬	vau
脲	vni
脶	vjr
脿	vqy
腈	vqv
腒	vnx
腘	vgl
腠	vqm
腧	vgp
腨	veh
腯	vwf
腴	vyk
腼	vtm
腽	vdc
膂	ytv
膊	vtu
膑	vlt
膙	vic
膦	vda
臃	vpr
臌	vpr
臑	vrh
臜	vfq
臬	dsm
臾	ykr
舁	ybc
舄	yfx
舠	lpd
舢	les
舣	lzh
舥	lob
舫	lyf
舭	lxb
舯	lro
舲	lrl
舳	lgy
舴	lra
舸	lxk
舻	lhn
舾	lux
艄	ldv
艅	lkw
艉	lne
艎	lnv
艚	lyd
艟	lkm
艨	lyr
艴	ino
艽	bmj
芄	bmz
芏	bat
芑	baj
芘	bxb
芟	bts
芠	bcw
芤	buw
芪	byv
芰	bur
芴	bfi
芼	bem
芾	bnc
苁	bkk
苄	bph
苈	bwi
苉	bak
苊	bwc
苌	bic
苎	ble
苒	bga
苘	bgj
苠	bbm
苤	bje
苧	blr
苫	bla
苴	bkq
苻	bmu
苾	bna
茀	bin
茁	bjg
茆	bym
茈	bjw
茋	byz
茌	bma
茏	bzl
茓	brx
茔	yat
茛	bmg
茝	bec
茭	bfh
茯	bmp
茳	qeg
茺	btk
茽	bmr
荁	beb
荄	bph
荏	bmv
荑	bki
荓	bsc
荖	baw
荙	bko
荛	bql
荥	yis
荦	yfn
荨	bou
荩	bnf
荬	bwk
荭	bye
荮	byu
荸	bfu
莅	bmk
莙	boj
莛	bvo
莝	bka
莨	bzm
莩	bau
莶	bgd
莸	bpd
莿	bnp
菉	boi
菍	brn
菏	qxk
菔	bvr
菘	bso
菝	bhr
菟	bzz
菠	qzp
菥	bsl
菪	blu
菰	bua
菹	qkq
菼	bxx
菽	bir
萆	bgu
萏	bqy
萑	bru
萘	bkl
萚	bhh
萜	bzl
萣	blh
萩	bwx
萳	bui
萹	bzy
葎	bkx
葑	bvu
葖	brp
葙	bsf
葚	bow
葜	bqk
葫	bxv
葰	bml
葳	big
葴	bim
葶	bcr
葸	bbn
蒄	bcu
蒇	biq
蒈	bxn
蒉	bcq
蒌	bdg
蒎	qwy
蒟	bks
蒨	bmv
蒯	bvp
蒱	bht
蒴	bsv
蒻	bif
蓁	bqw
蓂	ydf
蓇	bdg
蓊	btn
蓍	bad
蓏	baa
蓐	bzu
蓟	bzp
蓠	bpr
蓢	bzv
蓣	bct
蓥	ytj
蓰	bkh
蔀	bkf
蔃	bic
蔈	bul
蔊	bxk
蔌	bpn
蔟	byv
蔸	bnk
蔹	bgl
蔺	ber
蕈	buu
蕗	beo
蕞	bdr
蕤	brn
蕰	boc
蕹	bpr
蕺	bjq
蕻	bit
薁	bsk
薢	bqf
薤	bxe
薨	bcw
薮	bdl
薳	bao
薷	brh
薸	bol
薹	bqg
薿	bwh
藁	bcs
藟	bbb
藠	bnn
藦	bxh
藨	bax
蘅	bpk
蘘	byw
蘧	bxo
蘩	bty
虒	wxb
虓	mxb
虢	aub
虤	xbb
虬	cwe
虮	cbj
虷	ckg
虸	cui
虺	lcc
虼	ctw
虿	epc
蚄	cyf
蚆	cob
蚋	crn
蚍	cxb
蚓	cic
蚣	cto
蚧	ckn
蚨	cmf
蚪	cld
蚯	cle
蚱	cra
蚲	cks
蛃	cer
蛉	crl
蛏	cra
蛐	cyq
蛑	cof
蛔	cdh
蛘	ciy
蛞	cfs
蛩	ebc
蛲	cql
蛴	ccn
蛸	cdv
蜉	cau
蜊	cwp
蜎	cjv
蜐	cai
蜓	cvo
蜘	cvj
蜞	coq
蜢	cuc
蜣	ciw
蜩	cgq
蜮	cqm
蜴	cdi
蜻	cqv
蜾	cbs
蜿	clc
蝌	cwl
蝓	cgp
蝘	cag
蝙	czy
蝣	cyu
蝤	czq
蝥	clc
蝮	ctl
蝲	cpp
蝴	cxv
蝻	cui
蝽	cqd
蝾	cys
螂	czf
螅	cdn
螋	cyr
螗	cxj
螟	ccf
螠	csc
螣	vmc
螫	anc
螬	cyd
螭	cpr
螯	qpc
螱	nlc
螵	cul
螽	lfc
蟆	clm
蟊	ccc
蟋	cin
蟏	cbt
蟛	cpi
蟪	ctn
蟫	cuu
蟮	cij
蠊	cxn
蠋	ccc
蠓	cyr
蠕	crh
蠖	cbr
蠲	stc
蠹	fuc
蠼	cfr
衃	acj
衄	aca
衎	kkk
衒	kpk
衠	knk
衲	lrn
袈	ijy
袗	lki
袢	lsh
袤	ycm
袯	ljr
袱	lmp
袷	lgh
袼	log
裈	lcp
裉	lmg
裎	ljv
裒	yyj
裛	yjo
裟	ohy
裣	lgd
裥	led
裰	lrr
裼	ldi
褊	lzy
褓	lms
褕	lgp
褟	ldn
褫	lwb
褯	lxz
褰	lwy
襁	lic
襕	les
襚	lso
襜	lqi
襞	njy
襫	lku
襻	lch
觃	eui
觇	lej
觊	eae
觋	eke
觌	uwe
觎	gve
觏	wge
觖	qak
觚	qag
觞	qti
觟	qvg
觫	qps
觭	qkx
觯	qvu
觱	imq
觳	feq
觿	qej
訄	miy
訚	eiy
訾	jwi
詈	ciy
詟	ziy
謇	lwi
譬	nji
讣	ihb
讦	ikg
讧	ieg
讫	itw
讱	ipz
讵	iaa
讶	iay
讻	ihg
诇	igj
诋	iyz
诎	ijg
诐	izp
诔	its
诖	ivg
诜	ifk
诟	iwm
诠	ikv
诣	iwd
诨	icp
诩	inv
诮	idv
诰	ifj
诹	ifr
诼	irz
诿	iwg
谄	iqy
谆	icu
谇	ipu
谌	iow
谑	ixo
谖	iar
谞	ihv
谩	iqm
谪	ikx
谫	isp
谮	icd
谯	irx
谰	ies
谳	iup
谵	iqi
谼	cut
谿	ayc
豌	alc
豕	rss
豨	rhz
豮	ruq
豸	pii
貅	pms
貆	peb
貊	pub
貔	psx
贳	uwq
贶	qjk
贽	hmq
赀	jwq
赁	mvq
赂	qog
赅	qph
赆	qnf
赇	qiq
赈	qzc
赉	psq
赒	qgq
赓	xoq
赕	qxx
赗	qdf
赙	qtu
赜	ene
赝	wmq
赡	qqi
赧	anr
赪	anq
赳	dcj
趑	dfn
趯	dnr
趱	dfq
趵	efz
趼	eck
趿	erj
跂	eur
跆	eoj
跏	eij
跗	emu
跞	eyh
跣	efk
跱	ews
跸	exu
跻	ecn
跽	ean
踊	eoe
踌	equ
踒	ewg
踔	ehu
踣	ekj
踦	ekx
踬	ewq
踶	edh
踺	exo
踽	ear
蹀	eus
蹂	ecs
蹅	esb
蹈	eay
蹐	efv
蹑	efr
蹜	elu
蹢	ekx
蹯	eib
蹶	ewn
蹽	ekh
蹾	ecl
躇	eba
躏	ebr
躐	egy
躔	exa
躜	efq
躞	eir
轪	pkd
轫	ppz
轱	pxg
轲	pxk
轵	pjt
轷	pau
轸	pki
轹	pyh
轺	pma
轾	pgi
辀	plo
辁	pkv
辂	pog
辇	mmp
辊	pdx
辋	pgp
辌	pch
辎	pgb
辏	pqm
辒	pdc
辚	pda
辿	eod
迄	two
迓	aod
迕	tuo
迨	ojo
迮	rod
迳	reo
迺	uod
逅	wmo
逋	tod
逖	pxo
逡	oto
逦	evo
逭	ldo
逯	oio
逴	hdo
逵	ato
逻	cxo
遄	eho
遆	kzo
遘	wgo
遨	qpo
遴	dxo
遹	cgo
遽	xro
邂	qpo
邃	rso
邗	kfe
邘	euf
邙	pfe
邠	tpf
邡	yfe
邬	zfe
邯	yfe
邲	naf
邴	erf
邶	ywf
邺	nfe
邽	vfe
邾	apf
邿	wfe
郃	gfe
郄	huf
郇	fdf
郈	wmf
郏	msf
郐	ktf
郓	cpf
郗	huf
郚	vjf
郛	auf
郢	jvf
郤	cfe
郦	evf
郧	jqf
郪	xgf
郫	guf
郯	xxf
郴	cfe
郸	vuf
郾	adf
郿	nff
鄀	buf
鄃	gvf
鄄	uaf
鄅	ajf
鄌	xxf
鄑	enf
鄗	cfe
鄘	xxf
鄚	lfe
鄜	afe
鄠	ref
鄫	vdf
鄯	isf
鄹	frf
酂	fkf
酃	rdf
酅	erf
酆	eqf
酋	zqq
酎	zuc
酏	zdy
酗	zhg
酝	zty
酞	zkz
酡	zlw
酤	zxg
酦	zjr
酲	zjv
酴	zkw
酹	zau
酺	ztf
酽	zew
酾	zev
醌	zdx
醑	zhv
醢	zuc
醭	znz
醮	zrx
醵	zxr
醾	zxd
釐	plm
銎	ebt
鋆	aft
鋈	omt
錾	plt
鍪	clt
鎏	ott
鏊	qpt
鐾	njt
钆	twe
钇	twi
钋	thb
钌	ttl
钍	tat
钎	txq
钐	tis
钒	tbz
钔	tem
钖	twi
钘	tck
钤	trw
钨	tzu
钪	tpb
钫	tyf
钬	txh
钭	tld
钲	tbe
钷	taj
钹	tur
钽	tbd
钿	tbt
铆	tym
铈	tpz
铋	tna
铌	tnw
铏	tcp
铑	taw
铒	tfe
铕	tuv
铗	tms
铘	taf
铙	tql
铚	tgi
铟	tgk
铣	tfk
铥	tvo
铧	tmu
铨	tkv
铩	ths
铫	tkf
铴	toi
铷	tgj
铹	tyi
铻	tvj
铼	tps
铽	tqn
铿	tpa
锇	thq
锊	tau
锍	ttg
锏	ted
锒	tzm
锓	tor
锔	tnj
锖	tqv
锗	tae
锘	tbu
锛	tkb
锜	tkx
锞	tbs
锟	tdx
锢	tgx
锧	twq
锨	tln
锩	tmc
锪	tfn
锫	tkj
锬	txx
锲	tqk
锳	tbk
锴	txn
锶	tbn
锸	txy
锼	tyr
锽	tnv
锾	tar
锿	tyj
镃	tsy
镄	tiq
镅	tnf
镆	tlm
镈	ttu
镋	tdk
镎	tgh
镏	tyb
镒	tsc
镔	tlt
镘	tqm
镛	txe
镝	tkx
镞	tyv
镠	tni
镡	tuu
镢	twn
镤	tnz
镥	tzd
镦	tcl
镧	tes
镨	tsd
镩	trr
镪	tic
镮	tcy
镱	tsn
镳	tax
镴	tgy
镵	tzz
闩	eei
闱	ehw
闳	euo
闶	epb
闼	eko
闿	eea
阂	eph
阃	egs
阇	eae
阈	eqm
阊	edd
阋	eyk
阌	eir
阍	eyd
阏	eyf
阒	efp
阕	etm
阗	ent
阘	edn
阡	fxq
阱	fwj
阼	fra
阽	fla
陉	fre
陎	fap
陑	fhe
陔	fph
陛	fxa
陞	faa
陧	fml
陬	ffr
陴	fgu
隃	fgp
隗	fgo
隧	fso
隩	fsk
隰	fdx
隳	fuh
隹	ruu
隺	cru
雉	vru
雊	sru
雒	oru
雠	rir
雩	ree
雱	ryf
雳	rwi
霅	riy
霨	rnu
霪	rov
靬	zkg
靰	zlu
靸	zrj
靺	zpm
靼	zbd
靽	zsh
靿	zyi
鞁	zzp
鞒	zmn
鞔	zzk
鞡	zhk
鞣	zcs
鞧	zzq
鞨	zdp
鞫	zfi
鞬	zxo
鞮	zdh
鞯	zbu
鞲	zwa
鞳	zbg
鞴	zue
韂	zqi
韨	hur
韫	hdc
顸	kty
颃	pbt
颋	vot
颍	wit
颎	wxt
颔	rwt
颙	brt
颟	bet
颡	rrt
颢	xty
颥	rht
飐	bhl
飑	bho
飓	bht
飔	bhn
飗	bhb
飧	xws
餍	wpw
餮	xkw
饔	pyw
饧	wwi
饨	wej
饩	wtq
饪	wvw
饫	wmt
饳	wjg
饻	wyi
馈	wcq
馉	wdg
馌	wac
馏	wyb
馑	wzt
馔	wot
馘	sdm
馝	wda
馞	wdu
馧	wdc
驲	rdr
驵	rkq
驺	rqo
骀	roj
骃	rgk
骈	rsc
骉	rrr
骋	rge
骍	rfx
骎	ror
骒	rbs
骕	rxt
骖	roi
骘	fjr
骙	rtm
骠	rul
骢	rsn
骣	rnu
骦	rrf
骧	ryw
骰	dts
骱	dkn
骶	dyz
骷	dxg
骼	dog
髀	dgu
髁	dbs
髃	dbr
髑	dcc
髡	ilu
髢	idy
髦	iem
髫	ima
髭	ijw
髯	iga
髹	ims
髽	ika
鬈	imc
鬏	iwx
鬒	int
鬘	iqm
鬯	dgw
鬲	ugg
鬶	meu
鬷	uhl
鬻	idu
魃	gor
魆	goi
魈	gov
魋	gor
魑	gor
鱽	zpd
鱾	zaj
鲀	zej
鲂	zyf
鲃	zob
鲅	zur
鲆	zks
鲇	zla
鲈	zhn
鲉	zgy
鲊	zra
鲋	zmu
鲌	znb
鲏	zzp
鲐	zoj
鲒	zqj
鲕	zhe
鲖	zgm
鲗	zqp
鲘	zwm
鲙	zkt
鲚	zcn
鲝	izv
鲟	zou
鲡	zev
鲢	zpo
鲣	zpa
鲥	zdu
鲦	zls
鲧	zay
鲩	zlk
鲪	zoj
鲫	zmc
鲬	zoe
鲭	zqv
鲮	zal
鲯	zoq
鲰	zfr
鲱	zpf
鲲	zdx
鲳	zdd
鲴	zgx
鲵	zyk
鲷	zgq
鲹	zoi
鲺	zwc
鲻	zgb
鲼	zuq
鲽	zus
鲾	zmb
鲿	zdt
鳀	zdh
鳁	zdc
鳂	zby
鳅	zwx
鳇	znv
鳈	zni
鳉	zyu
鳊	zzy
鳏	zci
鳑	zky
鳒	zsn
鳕	zro
鳘	tnz
鳙	zxe
鳚	znu
鳛	znn
鳜	zwn
鳠	zbr
鳡	zin
鳢	zya
鳣	zpb
鳤	zkd
鸤	nzn
鸧	kcz
鸨	wuz
鸩	ckz
鸪	xzn
鸫	vhz
鸬	hnz
鸱	yvz
鸲	szn
鸶	yyz
鸷	hmz
鸸	hzn
鸹	fzn
鸺	msz
鸻	pzn
鸼	lzn
鹁	fuz
鹂	evz
鹆	czn
鹇	esz
鹈	sqz
鹉	eqz
鹋	bbz
鹌	kuz
鹍	dxz
鹎	guz
鹐	qyz
鹑	cuz
鹒	xoz
鹔	xnz
鹕	xvz
鹖	dfz
鹘	dzn
鹙	wxz
鹚	syz
鹛	nfz
鹝	uzn
鹠	ybz
鹡	ffz
鹢	stz
鹣	soz
鹦	qqz
鹧	xuz
鹨	nkz
鹪	rxz
鹬	cgz
鹮	cmz
鹯	pdz
鹱	zbr
鹲	yez
鹴	rsz
麀	awb
麇	awh
麈	azv
麋	adm
麑	ayk
麖	ach
麹	qld
黇	ugl
黉	dug
黝	syi
黡	wps
黥	sch
黧	wfs
黪	soi
黹	nwb
黻	nwr
黼	nwt
黾	jud
鼍	dbu
鼐	vfy
鼒	uay
鼗	kfr
鼙	puu
鼢	ytp
鼩	ysj
鼫	yus
鼱	yqv
鼷	yak
鼹	ydg
鼽	dbm
鼾	dbk
齇	dbk
齑	cne
龀	awb
龁	atw
龂	alj
龃	akq
龆	ama
龉	avj
龠	gdy
龢	gdw
鿍	ala
鿎	uko
鿏	tql
𠅤	pbn
𠙶	tgk
𠳐	jqf
𡎚	azy
𡐓	axi
𣗋	sdk
𣲗	ohw
𣲘	ocu
𣸣	ouq
𤧛	vkz
𤩽	vup
𤫉	vir
𥔲	ude
𥕢	uyd
𥖨	ujs
𥻗	dsb
𦈡	yrh
𦒍	kmn
𦙶	vxg
𦝼	vdg
𦭜	bjt
𦰡	bwf
𧿹	enm
𨐈	pdl
𨙸	urf
𨚕	obf
𨟠	fff
𨭉	cet
𨱇	tiq
𨱏	tbg
𨱑	tug
𨱔	tzu
𨺙	fyk
𩽾	zlg
𩾃	zzk
𩾌	zxi
𪟝	nil
𪣻	adg
𪤗	ani
𪨰	eyq
𪨶	ekp
𪩘	eup
𪾢	fej
𫄧	yao
𫄨	yhz
𫄷	ysn
𫄸	yxs
𫇭	bzz
𫌀	lne
𫍣	igm
𫍯	iim
𫍲	iyr
𫍽	icy
𫐄	plu
𫐐	pyk
𫐓	pcs
𫑡	juf
𫓧	tmf
𫓯	tvg
𫓶	tjv
𫓹	toq
𫔍	tib
𫔎	tcj
𫔶	eds
𫖮	eat
𫖯	kft
𫖳	oat
𫗧	wps
𫗴	wpb
𫘜	rcw
𫘝	rak
𫘦	rfb
𫘧	roi
𫘨	rdh
𫘪	rwh
𫘬	rak
𫚕	zpz
𫚖	jwz
𫚭	zgy
𫛭	pvz
𫞩	vbk
𫟅	ych
𫟦	pso
𫟹	tut
𫟼	tko
𫠆	urt
𫠊	rpy
𫠜	ayk
𫢸	mvu
𫫇	jen
𫭟	aah
𫭢	akw
𫭼	ayi
𫮃	avu
𫰛	gre
𫵷	ewi
𫶇	eyz
𫷷	xtn
𫸩	iah
𬀩	dhw
𬀪	dej
𬂩	sms
𬃊	swq
𬇕	oep
𬇙	oqb
𬇹	ogl
𬉼	xah
𬊈	xou
𬊤	xvu
𬌗	agh
𬍛	vyh
𬍡	owl
𬍤	vou
𬒈	dus
𬒔	ujv
𬒗	upe
𬕂	keq
𬘓	ygc
𬘘	yck
𬘡	ygk
𬘩	yvo
𬘫	ylk
𬘬	yqv
𬘭	ycl
𬘯	ycu
𬙂	ylg
𬙊	ysa
𬙋	yyw
𬜬	bej
𬜯	bek
𬞟	bjt
𬟁	buz
𬟽	cvh
𬣙	ieu
𬣞	ile
𬣡	ieq
𬣳	img
𬤇	iua
𬤊	idh
𬤝	itn
𬨂	pyv
𬨎	pzq
𬩽	ouf
𬪩	zcy
𬬩	tqi
𬬭	tkw
𬬮	tic
𬬱	tlj
𬬸	tsz
𬬹	tds
𬬻	thn
𬬿	tma
𬭁	tnm
𬭊	tsa
𬭎	tlo
𬭚	tcu
𬭛	toz
𬭤	tmv
𬭩	ttn
𬭬	tqo
𬭯	twl
𬭳	tpj
𬭶	tsh
𬭸	tda
𬭼	tso
𬮱	eua
𬮿	fea
𬯀	fcn
𬯎	fcq
𬱖	gty
𬱟	qwt
𬳵	rje
𬳶	rgj
𬳽	rfk
𬳿	rkw
𬴂	rpf
𬴃	rqu
𬴊	rda
𬶋	zsj
𬶍	zlw
𬶏	zqc
𬶐	zkf
𬶟	zpp
𬶠	zps
𬶨	mcz
𬶭	ztl
𬶮	zpj
𬷕	tzn
𬸘	adz
𬸚	piz
𬸣	lwz
𬸦	ytz
𬸪	ibz
𬹼	akn
𬺈	akx
𬺓	ach
