的	nf
一	ei
是	dh
不	jb
了	tl
在	ua
我	hq
人	kr
他	md
这	co
有	uv
个	kc
大	kd
上	is
中	ro
来	ps
地	ad
和	wj
说	iv
为	zi
们	me
到	gp
你	mq
就	ch
也	dy
以	wk
国	gl
那	wh
要	ug
出	jg
着	if
可	xk
道	sd
之	bi
对	ru
会	kt
自	di
而	he
得	kb
下	eh
能	ov
过	uo
生	ns
子	ui
于	eu
年	ta
后	wm
发	jr
都	af
里	ml
没	ot
所	zl
去	ao
事	mx
如	gj
用	ey
小	hx
作	mr
多	xx
行	px
只	jt
好	gu
成	iw
家	lr
天	mt
她	gd
方	yf
然	vp
当	do
心	nx
起	da
种	wr
想	sf
经	yr
现	ve
但	mb
无	cu
同	gm
进	wo
学	du
面	tm
其	oq
前	sv
已	ai
主	zv
动	ti
分	tp
把	ho
开	ck
又	ry
两	er
本	se
因	gk
部	kj
与	ew
将	yx
日	dr
长	ic
理	vm
三	os
实	lf
样	si
十	us
意	sn
知	vj
此	jw
第	kq
力	il
正	be
高	cg
手	hs
什	mu
身	gs
被	lz
明	dv
老	aw
者	ae
见	ej
机	sb
向	sj
最	df
使	mm
全	kv
点	lx
情	nq
外	xh
民	bm
并	sc
战	lq
关	sm
工	eg
等	kw
二	te
由	gy
性	nn
应	xd
间	ed
文	cw
给	yg
业	ny
真	nt
或	qm
政	bl
几	bj
利	wp
新	ks
位	mk
西	ux
再	na
加	ij
月	vy
制	fz
特	fw
果	bs
东	vh
神	ld
儿	ke
门	em
合	gh
信	mi
表	qy
原	wn
女	gn
更	pg
己	aj
名	xj
立	kl
比	xb
四	cs
斯	ol
次	fn
世	uw
便	mp
听	jl
提	hd
教	au
眼	fm
化	mw
通	oe
感	im
王	vw
各	og
口	jk
气	tq
别	ji
处	lh
变	qr
总	vn
条	ls
金	tj
及	rj
度	xu
让	ii
山	es
马	rm
数	dg
白	nb
员	jq
义	zh
至	gi
系	ay
难	rr
建	xo
件	mf
死	xw
完	lt
许	it
计	iu
怎	rn
光	dl
德	ku
形	ci
像	mz
务	li
书	ww
市	pz
师	pe
即	mc
带	yz
飞	wf
区	ah
李	su
则	qp
觉	de
社	la
今	rw
展	nu
连	po
叫	jc
治	oo
路	eo
万	ep
告	fj
科	wl
呢	jn
思	bn
转	pt
望	pv
边	io
风	bh
该	ip
象	zx
拉	hk
干	kg
收	cl
步	jh
领	rt
求	iq
未	pw
每	tn
式	qe
言	iy
吧	jo
确	uq
失	am
元	tk
运	to
令	rl
共	ut
士	as
改	al
英	bg
术	sz
车	pc
联	fs
争	qx
轻	pr
罗	cx
百	ub
离	ph
近	lo
组	yk
导	ou
候	ma
服	vc
突	rp
影	xi
证	ib
议	iz
存	uu
击	hg
精	dq
台	oj
黑	sh
调	ig
需	rh
支	ur
脸	vg
府	xm
周	gq
青	qv
红	ye
双	rs
九	mj
八	tb
片	yp
容	lc
曾	vd
落	qo
显	dn
尽	nz
党	dj
众	kk
备	lb
复	td
陈	fv
断	dw
写	ce
包	fo
病	ue
称	wq
倒	mg
绝	yq
敌	fl
技	hu
朝	ud
装	ya
视	le
增	av
谈	ix
惊	nc
古	xg
七	vq
留	yb
推	hr
注	oz
若	bu
奇	kx
委	wg
响	js
势	hm
历	wi
冷	fr
投	ht
农	cy
专	tw
皇	nv
土	at
局	nw
刘	cp
营	yj
父	th
依	my
千	xq
仍	mv
护	hz
竟	sk
某	ys
较	pf
防	fy
破	uz
故	xl
血	ac
节	bc
云	ty
母	nm
帝	kz
威	ie
革	zg
底	xy
音	sy
够	sx
责	ne
苦	bx
喜	pj
志	an
晚	dz
项	et
密	ln
验	rg
继	yd
否	jj
夜	pm
股	vt
续	yu
假	mn
帮	qf
乐	yh
陆	fh
退	mo
暗	ds
雷	rb
率	py
药	by
久	qz
助	ki
阳	fd
初	lp
预	ct
刻	pp
球	vi
树	sr
阵	fp
异	ob
宗	ll
育	tv
游	oy
胡	xv
食	ws
背	yw
穿	ra
福	lm
弟	sq
怀	nj
险	fg
财	qu
益	st
脚	va
疑	wv
赶	dk
劳	yi
置	cn
右	uy
压	wa
香	wd
略	bo
岁	ex
闻	ef
玉	lv
杨	sw
守	lu
田	bt
超	dm
皮	zp
喝	jd
角	qj
卡	ih
封	vu
策	kn
块	aa
配	za
姑	gx
刀	pd
草	bd
恐	eb
呼	ja
洲	od
检	sg
抗	hp
著	ba
肯	jv
露	re
掉	hh
亦	qi
沙	oh
宫	lj
魔	xc
耳	fe
孙	uh
临	pk
逃	kf
岛	ze
贵	cq
顺	gt
良	zm
朋	vv
亮	cb
闪	ek
礼	lw
艺	bw
丝	yy
渐	op
升	ab
抓	ha
炮	xf
诸	ia
败	ql
朱	ap
探	hc
移	wx
释	ir
旁	ky
春	qd
睡	fx
味	jp
杂	ms
雨	rv
湖	ox
钟	tr
丽	ev
域	aq
猛	pu
练	yv
旧	cd
庄	xa
旅	yt
忘	pn
肉	rk
祖	lk
票	ul
冰	fi
臣	ec
予	cv
俄	mh
尊	zu
凡	bz
厂	wc
丁	rd
迫	no
迅	wu
握	hn
绿	yo
午	tu
醒	zd
残	xe
戏	rq
折	hl
灯	xr
努	gr
哭	dp
阻	fk
罢	ca
础	uj
杜	sa
距	ea
川	gc
胸	vf
茶	bk
雅	ar
挂	hv
童	km
乘	wy
袭	zy
汇	oa
触	qc
魂	tg
巧	ee
奉	qh
鸟	zn
吓	je
驻	rz
凌	fa
融	uc
鼻	db
烦	xt
珍	vk
币	az
愈	gv
描	hb
穷	ri
绍	ym
启	zj
碎	up
虫	cc
裂	xp
颇	zt
悄	nd
躲	gb
咬	jf
艘	ly
扎	hw
崇	el
赖	pq
薄	qt
净	fq
巡	go
矛	cm
焦	rx
摄	hf
荡	qw
彭	pi
兼	so
酸	zo
戒	qb
悉	in
诊	ik
恋	qn
邓	rf
综	yl
殖	xn
陶	ff
惠	tc
汤	ow
宙	lg
铺	tt
勃	fu
册	yc
励	we
键	tx
尝	dt
浑	oc
鸣	jz
匹	ak
沟	of
泉	ni
晃	dd
猫	pb
绩	yn
瞪	ft
胖	vs
跪	eq
脏	vx
慰	nl
饰	wt
耗	ts
赔	qk
悬	ko
戈	qg
辖	pl
闷	en
邮	gf
枚	sl
梯	ss
涂	ok
烂	xs
惟	nr
覆	uk
愚	br
痕	um
赌	qa
苗	bb
妥	ag
涨	oi
雇	zr
肌	vb
履	nk
扯	hj
沃	om
翠	np
炉	xz
豫	cz
腔	vr
壳	fb
胃	bv
艳	qq
蓄	bp
漏	on
淮	or
茨	bf
姬	ge
晕	dc
赚	qs
甫	tf
姻	gg
啸	jx
饥	wb
歧	ju
躯	ga
鸭	gz
辰	zc
杭	sp
逸	zk
咐	jm
爽	kh
愧	ng
猿	pa
拂	hi
蹲	ez
胳	vo
蜀	cf
耽	fc
鹤	cr
腕	vl
捞	hy
稣	zw
帆	zb
塘	ax
禽	kp
奢	ka
旷	dx
畴	bq
酿	zz
蝇	cj
雯	rc
聋	zf
癫	un
胧	vz
妞	gw
悼	nh
吆	jy
枭	zs
谒	id
幔	zq
馋	wz
疱	uf
钨	tz
