的	nf
一	ei
了	tl
是	dh
不	jb
我	hq
在	ua
人	kr
有	uv
这	co
他	md
来	ps
个	kc
你	mq
说	iv
上	is
到	gp
就	ch
着	if
大	kd
们	me
道	sd
那	wh
么	aos
也	dy
地	ad
子	ui
下	eh
出	jg
时	duc
看	hfm
要	ug
她	gd
中	ro
没	ot
然	vp
里	ml
为	zi
过	uo
自	di
好	gu
得	kb
去	ao
可	xk
会	kt
天	mt
还	jod
心	nx
后	wm
以	wk
小	hx
都	af
和	wj
对	ru
想	sf
能	ov
起	da
之	bi
手	hs
而	he
只	jt
生	ns
什	mu
身	gs
头	fkd
样	si
事	mx
多	xx
己	aj
家	lr
面	tm
知	vj
开	ck
如	gj
无	cu
现	ve
很	kmg
点	lx
前	sv
发	jr
经	yr
情	nq
把	ho
老	aw
些	jwt
话	ifs
已	ai
又	ry
声	ans
意	sn
于	eu
回	dhh
笑	kmt
所	zl
但	mb
眼	fm
成	iw
方	yf
年	ta
见	ej
当	do
女	gn
真	nt
两	er
力	il
气	tq
从	kkr
用	ey
长	ic
动	ti
间	ed
国	gl
走	doo
让	ii
被	lz
给	yg
正	be
问	ejk
打	hrd
明	dv
儿	ke
法	oao
才	uap
几	bj
行	px
三	os
定	lhf
此	jw
进	wo
再	na
种	wr
将	yx
实	lf
同	gm
最	df
本	se
向	sj
分	tp
十	us
学	du
高	cg
第	kq
感	im
怎	rn
神	ld
听	jl
边	io
作	mr
其	oq
吧	jo
却	aoc
口	jk
觉	de
啊	jfx
因	gk
白	nb
次	fn
军	cpc
做	mxl
外	xh
门	em
光	dl
风	bh
主	zv
住	mzv
果	bs
与	ew
全	kv
二	te
候	ma
公	tos
相	sfm
吗	jrm
等	kw
别	ji
色	qob
死	xw
张	iic
部	kj
太	kzd
日	dr
少	hap
战	lq
理	vm
直	nii
重	xml
王	vw
像	mz
脸	vg
比	xb
快	nak
何	mxk
水	iss
名	xj
体	mse
呢	jn
东	vh
叫	jc
西	ux
应	xd
便	mp
放	ylx
马	rm
难	rr
轻	pr
更	pg
美	ikd
位	mk
关	sm
机	sb
接	hkg
先	fke
文	cw
处	lh
并	sc
望	pv
常	djz
完	lt
四	cs
飞	wf
师	pe
者	ae
安	lgn
清	oqv
刚	ghp
跟	emg
月	vy
信	mi
山	es
爱	iur
内	rnn
龙	zll
空	reg
带	yz
找	hqg
原	wn
入	krr
李	su
连	po
吃	jtw
场	awi
平	ksb
思	bn
林	cll
变	qr
使	mm
由	gy
受	iry
亲	ksm
命	gjc
目	fmm
强	ijc
男	bil
任	mvw
该	ip
路	eo
车	pc
今	rw
海	otn
加	ij
远	tko
活	ofs
特	fw
解	qpf
电	udd
世	uw
性	nn
表	qy
许	it
它	lwb
立	kl
黑	sh
金	tj
红	ye
花	bmw
转	pt
总	vn
算	kfb
城	aiw
队	fkr
孩	uph
反	wry
工	eg
始	goj
满	obk
新	ks
兵	ltb
物	ffi
离	ph
非	pff
虽	jcc
云	ty
似	mwk
万	ep
至	gi
干	kg
通	oe
认	ikr
失	am
火	xhh
哥	xxk
士	as
五	vuu
惊	nc
魔	xc
竟	sk
姐	gkq
乎	asu
剑	gdp
往	kzv
量	bml
早	dus
结	yqj
怕	nnb
流	otg
突	rp
坐	kka
斯	ol
音	sy
紧	pry
指	hwd
拉	hk
杀	hsm
半	shs
记	iaj
且	kqq
利	wp
合	gh
倒	mg
书	ww
度	xu
微	kbj
步	jh
教	au
喜	pj
越	diu
影	xi
谁	iru
冷	fr
深	ocs
告	fj
落	qo
象	zx
容	lc
怪	nra
传	mtz
钱	teq
提	hd
言	iy
随	fuo
每	tn
双	rs
服	vc
击	hg
武	eqj
哪	jwf
数	dg
站	kla
奇	kx
房	zyf
管	kld
灵	oxh
刻	pp
题	dht
衣	yii
周	gq
静	qvx
伤	mti
百	ub
拿	ghs
妈	grm
办	itb
星	dns
化	mw
功	eil
绝	yq
系	ay
般	lts
必	nap
业	ny
尔	qhx
件	mf
血	ac
代	mqi
精	dq
弟	sq
终	ylf
近	lo
条	ls
青	qv
界	bkn
司	wme
整	plb
欢	rnq
字	lui
晚	dz
民	bm
帮	qf
切	vpd
即	mc
忙	npw
交	fhi
或	qm
暗	ds
夫	mff
员	jq
根	smg
石	uss
哈	jgh
夜	pm
父	th
制	fz
友	ury
阿	fxk
息	dnx
冲	fro
酒	ozy
保	mjs
片	yp
形	ci
阵	fp
南	ugi
决	fak
请	iqv
各	og
报	hcr
兴	dtb
阳	fd
急	qon
语	ivj
令	rl
错	tud
及	rj
刘	cp
极	srj
识	ijt
备	lb
慢	nqm
雪	row
苦	bx
若	bu
领	rt
收	cl
底	xy
尽	nz
准	fru
华	mwu
答	kgh
众	kk
千	xq
消	odv
视	le
罗	cx
敢	wfl
留	yb
克	xke
乐	yh
够	sx
跑	efo
显	dn
嘴	jjq
官	ldh
断	dw
未	pw
势	hm
句	sjj
求	iq
计	iu
论	ikw
达	kod
则	qp
害	lqj
八	tb
单	vus
久	qz
脚	va
德	ku
元	tk
脑	vpg
楚	chf
雨	rv
睛	fqv
响	js
刀	pd
确	uq
玉	lv
沉	ocb
北	ywb
格	sog
停	mcr
陈	fv
市	pz
朝	ud
喝	jd
族	ytv
江	oeg
团	gua
母	nm
章	sus
装	ya
亮	cb
客	log
照	dmx
乱	fwe
易	dfi
足	euu
依	my
黄	ugy
修	mli
破	uz
台	oj
球	vi
呀	jay
院	flk
送	smo
包	fo
义	zh
诉	ilz
攻	elx
丝	yy
围	ghw
玩	vtk
待	kws
复	td
况	fjk
楼	sdg
丽	ev
痛	uoe
梦	cxx
呼	ja
摇	hab
期	ovy
英	bg
低	myz
帝	kz
兄	jke
背	yw
持	hws
爷	thc
皇	nv
七	vq
六	fll
穿	ra
杨	sw
政	bl
运	to
居	nxg
叶	jus
热	hmx
校	sfh
谢	igu
曾	vd
古	xg
细	ybt
产	kwc
睡	fx
希	huz
速	pod
室	lgi
旁	ky
另	jil
怀	nj
露	re
异	ob
写	ce
鬼	gos
娘	gzm
取	fry
式	qe
除	fkw
级	yrj
考	aek
建	xo
愿	wnn
招	hma
饭	wwr
布	uzj
续	yu
程	wjv
首	sdi
观	rej
朋	vv
务	li
掉	hh
赶	dk
忽	fin
注	oz
术	sz
甚	owe
差	ieg
呵	jxk
展	nu
争	qx
品	jdh
兰	sos
宝	llv
香	wd
斗	ldd
故	xl
雷	rb
念	rwn
段	hts
顿	ejt
角	qj
疑	wv
护	hz
闪	ek
木	smm
需	rh
调	ig
类	dkd
妹	gpw
爸	tho
线	yeq
左	ueg
游	oy
派	owy
谈	ix
激	onl
冰	fi
敌	fl
跳	ekf
支	ur
约	yfz
巴	obb
您	mqn
顾	wct
肯	jv
醒	zd
铁	tam
抱	hfo
淡	oxx
造	fjo
伙	mxh
资	fnq
群	oai
集	rsm
联	fs
商	ktj
号	jek
节	bc
讲	iwj
掌	djh
赵	dhi
密	ln
九	mj
病	ue
卫	cei
米	dmm
威	ie
继	yd
渐	op
统	ytk
追	ado
亚	eny
简	ked
练	yv
基	oat
选	fko
推	hr
改	al
退	mo
味	jp
份	mtp
举	dth
示	lss
忍	pzn
历	wi
器	dpd
恐	eb
引	ics
试	iqe
皮	zp
习	nxx
靠	fjp
导	ou
存	uu
莫	lmm
志	an
区	ah
汉	ory
右	uy
严	enw
态	kzn
买	wfk
幸	aiy
社	la
佛	min
议	iz
树	sr
止	jii
块	aa
守	lu
毛	emm
挥	hcp
胡	xv
散	uvl
板	swr
仅	mry
隐	fqn
怒	grn
床	xsm
苏	bit
料	dld
股	vt
局	nw
班	vpv
图	glf
岁	ex
礼	lw
独	pcc
初	lp
福	lm
顺	gt
狂	pvw
默	spq
巨	aak
既	mcu
松	sto
证	ib
烈	xpx
否	jj
恶	enn
治	oo
缓	yar
排	hpf
费	inq
拍	hnb
耳	fe
医	avs
寒	lwf
哭	dp
温	odc
府	xm
担	hbd
称	wq
余	kwh
钟	tr
泪	ofm
烟	xgk
仍	mv
具	ktb
忘	pn
恩	gkn
毕	xus
警	bsi
蓝	bpc
宫	lj
吸	jrj
陆	fh
究	rmj
抓	ha
压	wa
沙	oh
救	ilx
呆	jsm
河	oxk
迷	dod
枪	skc
组	yk
权	sry
叹	jry
孙	uh
卷	mcj
查	sbd
毫	cem
春	qd
察	ltl
圣	rat
草	bd
较	pf
胜	vns
遇	bro
充	tke
史	jhi
堂	dja
防	fy
据	hnx
猛	pu
骑	rkx
土	at
卡	ih
助	ki
京	chx
银	tmg
贵	cq
永	zis
质	wuq
屋	ngi
须	ity
副	mbp
换	hqk
刺	npd
属	nar
闻	ef
境	ask
禁	cls
阴	fvy
共	ut
负	qqb
弄	vbc
翻	ibn
虎	xbj
层	nty
喊	jim
逃	kf
晓	dql
座	xka
雅	ar
参	oki
射	guc
婚	gyd
险	fg
君	oaj
划	qpd
坚	pra
价	mkn
柔	csm
超	dm
扬	hwi
科	wl
按	hlg
狠	pmg
野	mcv
秦	qwh
秘	wna
熟	cux
置	cn
仙	mes
模	slm
伸	mds
波	ozp
肉	rk
假	mn
齐	cnd
舞	tba
脱	vvk
广	xgg
姑	gx
麻	xcl
投	ht
顶	rty
致	glx
责	ne
景	xjj
营	yj
维	yru
设	its
坏	ajb
啦	jhk
秀	wvn
败	ql
眉	nfm
州	dgc
药	by
承	wio
案	lgs
狼	pzm
专	tw
偷	mgp
画	ebg
吴	jmt
店	xla
哦	jhq
弹	ivu
食	ws
欲	cnq
抬	hoj
标	sls
秋	wxh
厉	wep
良	zm
际	fls
状	ypq
烦	xt
午	tu
摆	hco
戏	rq
桌	hds
船	lbj
短	vad
村	suc
某	ys
摸	hlm
付	muc
演	olg
规	mej
萧	bxt
封	vu
握	hn
田	bt
唐	xxj
藏	bie
震	rzc
混	odx
虚	xny
透	wvo
纪	yaj
凌	fa
休	msm
嘛	jxc
梅	stn
紫	jwy
歌	xxn
临	pk
毒	qnm
宗	ll
著	ba
索	fys
印	yec
寻	ouc
湖	ox
劲	rei
职	fjt
技	hu
恨	nmg
婆	ozg
杰	sxh
羽	nvv
咱	jdi
素	qys
凡	bz
值	mni
飘	ulh
养	izn
嘿	jsh
普	snd
宁	lrd
吓	je
兽	vme
夏	tlx
读	iuk
街	pvg
牛	fnn
仿	myf
胸	vf
浪	ozm
富	lmb
尚	djk
宇	leu
骨	dgg
智	vjd
纷	ytp
升	ab
叔	ihr
善	isj
弱	iff
架	ijs
卖	uwk
袋	mqy
网	ghh
朱	ap
骂	drm
雄	uor
赛	lwq
略	bo
杯	sjb
施	ytd
墙	aad
环	vjb
罪	cpf
牙	ayy
窗	rsl
柳	sym
厅	wrd
搞	hcg
端	keh
洞	ogm
适	fod
拥	hey
释	ir
洋	oiy
肩	zvy
魂	tg
闹	epz
蒙	yer
洗	ofk
灯	xr
借	mud
伯	mnb
免	zke
菜	bic
验	rg
凤	bry
鱼	zvv
徐	kkw
型	cpa
娜	gwf
暴	dui
亡	pww
讨	iuc
辈	ppc
懂	nbm
腿	vmo
灭	exh
妙	gha
效	fhl
危	qwc
优	mdy
盘	lcm
套	kic
丁	rd
趣	dfr
妖	gmt
束	pss
杂	ms
诗	iws
迎	yco
舍	kfs
旧	cd
彩	iis
委	wg
挂	hv
笔	kem
狗	psj
鲜	ziy
纸	yyv
抗	hp
探	hc
韩	udh
尼	nwb
控	hre
惜	nud
珠	vap
抽	hgy
创	kcp
归	pow
挺	hvo
奋	kbt
陪	fkj
硬	upg
避	njo
园	gtk
托	hav
训	igc
勇	oei
聊	fym
奶	gvn
庄	xa
奔	kub
镇	tnt
拳	mhs
采	icc
研	uck
配	za
介	knd
尊	zu
冒	dfm
虑	xnx
敬	bsl
丹	gpp
舒	kfc
蛋	hcc
哼	jct
宋	lsm
济	ocn
妇	gow
箭	ksp
择	hrh
犯	pcj
欣	lnq
甲	gjj
欧	ahn
课	ibs
扑	hhb
菲	bpf
燕	ujx
曲	yqq
躲	gb
玄	pyy
幻	ywe
茶	bk
折	hl
伊	moa
傻	msl
姓	gns
源	owh
洛	oog
遍	zyo
臣	ec
弃	tbc
犹	pdy
占	laa
漂	oul
挑	hkf
获	bpp
绿	yo
峰	elq
俊	mol
疯	ubh
列	xpd
森	scl
妻	xgn
恋	qn
误	ijm
拜	heq
伟	mhw
移	wx
纳	yrn
党	dj
罢	ca
腰	vug
巧	ee
孤	uag
闭	eua
圆	gjq
碰	usn
镜	tsk
软	pnq
厚	wdu
累	bys
昨	dra
幽	eyy
悲	pnx
丈	ehi
牌	ygu
降	fla
颜	kwt
劳	yi
偏	mzy
省	haf
糊	dxv
馆	wld
烧	xql
谓	ibv
财	qu
舰	lej
汗	okg
奈	kls
操	hjs
迹	qod
尸	nss
悄	nd
残	xe
尖	hkd
鲁	zdr
锋	tlq
圈	gmc
油	ogy
俩	mek
项	et
撞	hkm
瞬	fia
忆	nwi
盖	icm
尤	dyy
徒	kdo
乡	yxx
概	smc
户	zhh
荡	qw
艺	bw
增	av
祖	lk
困	gsm
殿	nut
迅	wu
横	sug
范	qcj
律	kxv
番	ibt
企	kji
惨	noi
限	fmg
聚	fri
含	rwj
凭	mvb
剧	nxp
碎	up
躺	gdj
缘	yor
凉	fch
腾	vmr
织	yjt
抢	hkc
预	ct
沈	ock
替	mmd
孔	uwe
批	hxb
康	xxi
惑	qmn
唯	jru
率	py
惯	nnq
登	tad
互	eow
盯	frd
稍	wdv
宣	leb
唱	jdd
诚	iiw
剩	wyp
咬	jf
育	tv
诸	ia
触	qc
晨	dzc
策	kn
疼	ulf
漫	oqm
材	sua
补	lhb
私	wos
吐	jat
纯	yej
艾	bhi
贝	qbb
谷	cgg
庭	xvo
挡	hdo
晃	dd
吉	qjj
吹	jnq
仔	mui
仇	mmj
凝	fwh
鼓	pur
农	cy
席	xuz
征	kbe
帅	pzj
附	fmu
缺	bak
塞	lwa
豪	crs
亦	qi
杜	sa
努	gr
判	shp
谋	iys
胆	vbd
尘	hat
扎	hw
滚	oyo
闷	en
迟	nzo
稳	wqn
翼	nbt
诺	ibu
闲	esm
灰	uxh
朵	bsm
盛	iwc
梁	ops
晶	ddd
餐	xrw
爆	xdi
伦	mkw
娇	gmn
侧	mqp
愣	ncy
鼻	db
轮	pkw
昏	yvd
抖	hld
陷	fqy
敏	tnl
词	iwm
慌	nbg
愤	nuq
怜	nrl
颤	pdt
阶	fkn
苍	bkc
距	ea
郑	smf
川	gc
扫	how
逼	mbo
县	kos
忧	ndy
童	km
执	hmz
丢	vos
荣	ysm
臂	njv
逐	rod
傲	mql
戴	uqt
芒	bpw
庆	xkd
伴	msh
袭	zy
供	mut
积	wjt
测	oqp
遥	abo
阻	fk
例	mxp
睁	fqx
岛	ze
遗	cqo
瞪	ft
慕	lhx
皱	qoz
博	utu
幕	lzj
猜	pqv
益	st
净	fq
泽	orh
炼	xvh
监	pkc
鸡	rzn
珍	vk
伏	mpq
绍	ym
曹	ydr
爬	aob
丫	scs
炸	xra
壁	nja
涌	ooe
凶	hgk
郎	zmf
宿	lmu
怨	xcn
醉	zpu
拼	hsc
迫	no
革	zg
瞧	frx
奥	sdk
输	pgp
莉	bwp
忠	rnx
颗	bst
嗯	jgn
佳	mvg
旅	yt
仁	mte
鸟	zn
骗	rzy
浩	ofj
塔	abg
胖	vs
绪	yae
枫	sbh
拔	hur
赞	fkq
炮	xf
傅	mtu
凯	eab
邪	afe
芳	byf
浑	oc
夺	kuc
宽	lbe
堆	aru
裂	xp
遭	ydo
赤	any
旋	yth
扭	hwa
洁	oqj
浮	oau
悉	in
擦	hll
慧	qqn
典	ytb
赏	djq
匆	fiz
评	iks
纵	ykk
莲	bpo
雾	rli
乌	zuu
跃	emt
壮	yas
贴	qla
丰	qff
隔	fug
健	mxo
辛	fxx
抵	hyz
竹	kuu
彻	kvp
摩	xch
轰	prs
编	yzy
肚	vat
插	hxy
磨	xcu
哎	jbh
御	kbc
耐	huc
惧	nkt
氏	yvq
辉	dlp
扶	hmf
恢	nux
貌	pnk
额	lot
述	szo
票	ul
录	ois
拖	htd
膀	vky
鹰	xmz
孟	ucm
递	sqo
瑞	veh
唇	zjk
暂	pld
货	mwq
琴	vvw
踪	ell
码	urm
慰	nl
蛇	clw
玲	vrl
晕	dc
损	hjq
轩	pkg
粗	dkq
掩	hku
屁	nxb
悠	mln
仰	myc
零	rrl
盟	dvc
途	kwo
贼	qqu
洪	out
悟	nvj
固	gxg
讶	iay
冬	lfb
滑	odg
甜	fyg
郁	uvf
琳	vcl
辆	pek
乃	vnn
猪	pae
暖	dar
妮	gnw
挣	hqx
旦	bdd
估	mxg
坦	abd
甘	ygg
佩	mbz
莱	bps
享	cui
吼	juw
构	sfo
粉	dtp
萨	bfw
吻	jfi
潜	omd
瓶	scm
偶	mbr
戒	qb
浓	ocy
毁	yet
销	tdv
迪	god
拒	haa
绕	yql
勒	zil
朗	zmv
嘻	jpj
尾	nem
帐	zic
废	xjr
延	ajo
敲	cxd
烂	xs
曼	qmm
厌	wpq
宜	lkq
羞	iwa
喂	jby
吟	jrw
滴	okx
洲	od
爹	thx
艳	qq
晴	dqv
抚	hcu
缩	ylu
协	uit
央	gkd
悔	ntn
肖	dvy
缠	yxm
脆	vqc
痕	um
伍	mvu
寂	lir
启	zj
翔	inv
薄	qt
侯	mav
劝	ril
郭	cuf
奴	gry
鸣	jz
倾	mwt
彼	kzp
扔	hvn
撒	hul
豫	cz
检	sg
针	tus
耀	dlr
痴	uvj
姆	gnm
篇	kzy
椅	skx
厂	wc
董	bxm
熊	ovx
埋	aml
乖	xyw
狐	pag
蒋	byu
踏	eid
隆	fln
括	hfs
潮	ouv
唉	jov
穷	ri
聪	fvn
唤	jqk
泰	qis
版	ywr
末	pmm
旗	yto
仪	mzh
焦	rx
猫	pb
盗	fnc
侍	mws
挤	hcn
款	aln
拾	hgh
荒	bpg
姿	fng
域	aq
搭	hbg
脉	vzi
授	hir
俗	mcg
融	uc
狱	pip
欺	onq
访	iyf
桥	smn
锁	tdq
霸	rzv
牵	kcf
池	ody
钻	tla
港	ouo
喃	jui
廷	voy
乘	wy
玛	vrm
奉	qh
扯	hj
岳	lee
减	fim
弯	qig
夹	msb
辞	ffx
岸	ewk
岂	eaj
屈	njg
恼	npg
哲	hlj
季	wui
召	maa
丧	asy
尝	dt
恭	uth
载	uqp
瘦	uyr
皆	xnb
颇	zt
茫	qpw
染	oms
肃	xnt
爽	kh
亏	eek
吞	mjk
惹	bun
哀	yjk
乔	mnd
趁	dki
铺	tt
脏	vx
吕	jjk
奖	yxk
倍	mkj
汤	ow
振	hzc
婷	gcr
牢	lfn
扰	hdy
溜	oyb
庞	xzl
臭	dpq
悦	nvk
赫	ann
赢	pjq
跪	eq
麦	qlx
枝	sur
侠	mms
泉	ni
劫	aoi
炎	xxh
泥	onw
赌	qa
弓	igg
魏	wgo
罩	chu
疾	uvs
饰	wt
符	kmu
垂	xbt
映	dgk
漠	olm
脖	vfu
饮	wnq
沿	obj
懒	npq
肤	vmf
桑	rrs
堪	aow
燃	xvx
卓	hdu
祝	ljk
赖	pq
宾	llt
贾	uqb
喘	jeh
焰	xqy
吵	jha
冥	cdf
鞋	zvg
逸	zk
均	aff
库	xpc
裤	lxp
碗	ulc
航	lpb
踢	edi
姨	gki
酸	zo
啸	jx
龄	arl
阁	eog
舌	fss
箱	ksf
冯	frm
邦	qfe
钢	tgh
霞	rnr
促	meu
泡	ofo
盾	wuf
羊	iyy
碧	vnu
援	har
忌	anx
抹	hpm
倩	mqv
锐	tvk
喷	juq
拦	hso
嘉	pij
袖	lgy
殊	xap
辰	zc
繁	tny
络	yog
抛	hmi
嫁	glr
咒	dbj
撤	htl
键	tx
湿	odn
恰	ngh
虫	cc
审	lds
献	ugp
媚	gnf
贤	prq
葛	bdp
刹	hsp
袁	ajy
摔	hpu
序	xcv
筑	kez
斜	kwl
瓦	mww
涂	ok
湾	oqi
莎	qha
崇	el
猎	pud
刑	cpd
墨	sat
娃	gvg
梯	ss
桃	skf
豆	add
驾	ijr
浅	oeq
径	kre
饿	whq
疲	uzp
搬	hlt
瓜	agg
莹	ylv
滋	osy
润	oev
铃	trl
蛮	qcc
蒂	bkz
拨	hjr
涛	oqu
予	cv
勾	fos
惠	tc
析	slj
砍	unq
撑	hdh
截	uqr
措	hud
币	az
薇	bkb
愈	gv
督	ihf
酷	zfj
祥	liy
怖	nuz
侵	mor
岩	eus
扮	htp
糟	dyd
盈	vrc
腹	vtl
斩	plj
尺	nzd
签	kgd
稀	whz
掏	hfb
夸	kee
汽	otq
液	opl
姬	ge
愧	ng
汇	oa
柱	szv
粮	dzm
堡	mja
仗	meh
笨	kse
奏	qmt
歉	son
甩	ewe
怔	nbe
允	oke
竞	kjk
祸	ljr
耶	ffe
爵	acu
绩	yn
诱	iwv
呜	jzu
穴	rxx
黎	wfi
租	wkq
培	akj
砸	uaz
麽	xco
井	wjj
窝	rjr
弥	iqh
返	wro
匹	ak
啥	jkf
凑	fqm
奸	gkg
陌	fub
叛	shr
核	sph
卧	ehb
幅	zmb
眨	fab
耗	ts
洒	oux
怡	noj
详	iiy
卢	hns
扣	hjk
哇	jvg
丑	wat
勉	zki
孝	aui
矛	cm
氛	ttp
衡	pzk
陶	ff
购	qfo
汪	ovw
僵	mee
疗	utl
妃	gaj
罚	cip
棋	soq
缝	ylo
咐	jm
躯	ga
泛	oab
愁	wxn
搜	hyr
慈	syn
肥	vob
笼	kzl
篮	kpc
俱	mkt
惟	nr
柜	saa
捉	heu
悬	ko
霍	rru
泄	ouw
咽	jgk
齿	acc
秒	wha
勤	zti
扩	hxg
屏	nsc
霜	rsf
袍	lfo
蝶	cus
祭	tls
厨	wau
胁	vit
璃	vpr
劈	njp
赚	qs
锦	tnz
尬	dkn
尴	dpc
熙	eox
寺	wss
昌	ddr
贺	ijq
巾	zjj
描	hb
捕	htf
陵	fal
咳	jph
扇	znv
虹	ceg
绵	ynz
撕	hol
蔡	btl
催	mer
彭	pi
宠	lzl
贪	rwq
辱	zuc
誓	hli
盒	gcm
寸	ucc
披	hzp
搂	hdg
饶	wql
跌	eam
欠	nqq
肌	vb
售	rjk
巡	go
抑	hyc
纹	ycw
宏	luo
幼	yil
萍	qks
驻	rz
丛	kke
亿	mwi
播	hib
俄	mh
刃	pzd
蕾	brb
挨	hov
仲	mro
迈	epo
违	hod
辩	fif
埃	aov
艘	ly
琪	voq
灾	lxh
僧	mvd
渡	oxr
卑	gus
雕	gqr
鼠	yss
讯	iwu
辣	fps
刷	nzp
艰	rmg
斥	lzd
裙	loj
翠	np
饱	wfo
掠	hch
询	ifd
勃	fu
夕	xxx
矮	vwg
瑶	vab
赐	qdi
捏	hml
闯	erm
姚	gkf
瑟	vva
渴	odp
谅	ich
昂	dyc
串	rro
沟	of
涉	ojh
咕	jxg
驶	rjh
摄	hf
贫	tpq
辕	pay
婉	glc
鹏	vvz
姜	ign
碍	ubu
荷	bmx
冠	ctu
魅	gop
玫	vlx
裁	uqy
坡	azp
鸿	oez
邓	rf
歪	jbe
乏	abi
申	dss
割	lqp
巫	ekk
衫	lis
棒	sqh
阔	eof
泣	okl
韦	hww
恍	ndl
贯	nqb
魄	ngo
柄	ser
患	rrn
覆	uk
蜜	lnc
婴	qqg
励	we
锅	tjr
陛	fxa
遮	xuo
帕	znb
咖	jij
嫌	gsn
胳	vo
挖	hrw
啪	jhn
矿	uxg
凄	fxg
爪	auu
眠	fbm
穆	wni
啡	jpf
吾	vjk
坛	aty
脾	vgu
恒	neb
屠	nae
玻	vzp
蓉	blc
础	uj
曰	drr
耸	kkf
膊	vtu
後	kyl
逆	sjo
寿	quc
驱	rah
猴	pmv
佣	mey
毅	krt
舅	ybi
铜	tgm
娟	gjv
眯	fdm
淫	oav
吩	jtp
匪	apf
牧	flx
役	kts
寄	lkx
诡	iqc
纤	yxq
腐	xmk
姻	gg
晰	dsl
渊	ond
亭	crd
邀	nyo
哄	jut
骚	rrc
墓	lat
柯	sxk
筋	kvi
崔	eru
灿	xes
捷	hxh
淋	ocl
弗	ind
辑	pjf
棍	sdx
绳	yju
频	jht
廊	xzf
畏	bey
歇	dfn
裹	ybs
苗	bb
盼	ftp
咯	jog
耍	hgn
煞	qox
寝	lyr
瞒	fbk
添	omh
嫂	gyr
纠	ycj
慨	nmc
嚷	jyw
驰	rdy
拐	hji
宴	ldg
津	oxv
岚	ebh
浴	ocg
耻	fji
挽	hzk
页	tyy
誉	dti
牲	fns
乳	auw
仓	kcj
逝	hlo
喉	jmv
逛	pvo
樱	sqg
兼	so
戈	qg
哗	jmu
涯	owv
捧	hqh
铭	txj
障	fsu
摊	hrr
跨	eke
妥	ag
揉	hcs
晋	end
寞	llm
寨	lws
漆	osi
污	oee
嘲	juv
枚	sl
吊	jzj
乾	udw
馨	and
伪	mzz
嗓	jrs
呈	jvw
卿	ymg
楠	sui
籍	ktd
裸	lbs
链	tpo
灌	obr
昆	dxb
畅	dwi
逍	dvo
帽	zdf
阅	evk
逗	aod
蹲	ez
踩	eic
窜	rrr
哑	jen
趴	etb
逢	lqo
植	sni
媒	gys
韵	sff
昭	dma
尹	oap
谦	isn
档	sdo
趟	ddj
沾	ola
兔	zkz
订	ird
朴	shb
瞎	flj
鞭	zmp
俺	mku
斤	ljj
翅	urn
肠	vwi
雀	hru
慎	nnt
盆	tpc
迁	xod
镖	tul
芬	btp
崖	ewv
丘	lei
蠢	qdc
庙	xgy
潘	oib
颖	wwt
拓	hus
娶	frg
纱	yha
漏	on
谨	izt
珊	vyc
仆	mhb
宙	lg
尉	nlu
屑	ndv
叮	jrd
捂	hvj
涩	opj
诧	ilv
柴	jws
杆	skg
涵	owg
坠	fka
赔	qk
涨	oi
嘟	jaf
崩	evv
薛	baf
藤	bvi
税	wvk
枯	sxg
译	irh
帘	rzj
糖	dxj
愉	ngp
骄	rmn
羡	ifn
糕	dix
彬	cis
愚	br
疏	htg
翰	udn
堵	aae
腕	vl
眸	fof
芸	bty
溪	oak
殷	wot
谎	ibg
鼎	fyy
稿	wcg
哟	jyz
冤	czz
症	ube
棵	sbs
狄	pxh
咧	jxp
湘	osf
宛	lxc
嫩	gpl
肆	ixv
宰	lfx
憾	nin
偿	mdt
腔	vr
哩	jml
豹	pfz
瑰	vgo
鉴	pkt
绑	yqf
潇	obt
戚	iih
郡	oaf
澡	ojs
桂	svg
兮	tek
雯	rc
颠	ntt
狮	ppz
邻	rfe
契	qpk
骇	rph
卜	hbb
揭	hdp
妄	pgn
坑	apb
伐	mqg
矩	vaa
烁	xyh
葬	bxb
诀	iak
鄙	juf
鹿	all
柏	snb
溃	ocq
朕	vsm
舟	loo
妆	ygn
躁	ejs
霉	rtn
侦	mhq
冻	fvh
娅	gen
庸	xxe
筹	kqu
削	dvp
砰	uks
耿	fxh
牺	fux
筒	kgm
遂	sro
旭	mdr
胎	voj
惶	nnv
淑	oir
叉	rzd
痒	uiy
竖	prk
龟	qud
斑	vcv
儒	mrh
嫣	gbx
宅	lav
押	hgj
胃	bv
旨	wdr
册	yc
膝	vsi
浸	oor
弦	ipy
栏	sso
衷	yro
刮	fpd
艇	lvo
岗	egh
赴	dhb
囊	fdy
斧	thl
颊	mst
疆	iae
炉	xz
塌	adn
乞	twi
旺	dvw
烤	xae
黛	mqs
逊	uho
贱	qeq
辨	fpf
狸	pml
叙	kwr
愕	nde
叠	rrk
遣	cdo
晌	dsj
麟	ada
腥	vdn
粒	dkl
拟	hwk
俏	mdv
杖	seh
芝	bbi
夷	kig
衬	luc
佐	mue
巷	uto
捡	hgd
遵	zuo
塑	sja
桶	soe
泼	ojr
滩	orr
琼	vch
昊	dmt
帆	zb
搏	htu
颈	ret
噢	jsk
蹦	eev
寡	ltp
贞	hqb
凰	bnv
哨	jdv
拆	hlz
茹	bgj
劣	hai
嘱	jnr
沃	om
厢	wsf
摘	hkx
咋	jra
坤	ads
俯	mxu
媳	gdn
赋	qej
嘶	jol
贡	eqb
碌	uoi
匙	dhw
拢	hzl
谭	iuu
翁	ton
辜	xfx
竭	kdp
廉	xsn
械	sqb
贸	yqb
辅	ptf
讽	ibh
呐	jrn
斌	cej
辽	tod
填	ant
窃	rvp
抄	hha
溢	osc
妒	gzh
吁	jeu
嗦	jfy
掀	hln
芙	bmf
祈	llj
栋	svh
吱	jur
撇	hwl
胞	vfo
轿	pmn
禅	lvu
妨	gyf
拂	hi
倦	mmc
衰	ygt
靖	kqv
循	kwf
挪	hwf
蓬	blo
惩	kbn
垃	akl
账	qic
驳	rhh
署	cae
甫	tf
顽	tkt
姥	gaw
圾	arj
熬	qpx
枕	sck
丐	ehw
茜	bux
咦	jki
厕	wqp
攀	chh
彤	gpi
妍	gck
拽	hda
荆	bcp
妓	gur
壶	fny
於	ykf
寇	ltx
鹤	cr
钥	tvy
骤	rfi
渺	ofa
刊	kpd
肢	vur
烛	xcc
孕	vui
绽	ylh
彦	kwi
棉	snz
俘	mau
盔	uxc
剪	svp
诞	iao
兜	nyk
凛	fpl
岭	erl
嚣	dtd
溅	oqq
笛	kgy
舱	lkc
罕	ctk
鸭	gz
债	mne
噬	jkk
钉	trd
躬	gig
倚	mkx
缕	ydg
咚	jlf
撼	hin
蕊	bnn
侄	mgi
佑	muy
雁	wmr
隶	xis
践	eeq
拱	hut
沐	osm
菊	bfd
蜂	clq
裕	lcg
兆	kff
搅	hde
尿	nis
黯	ssy
歹	xdd
蓄	bp
朦	vyr
嘀	jkx
怯	nao
叨	jpd
纽	ywa
聘	fge
腻	vqq
剥	oip
彪	xbi
沸	oin
氓	pbm
榜	sky
逻	cxo
壳	fb
储	mia
憋	wln
啤	jgu
匠	alj
悍	ndk
昧	dpw
泊	onb
篷	klo
烫	owx
狡	pfh
轨	pmj
汹	ohg
携	hrv
磊	uuu
隙	fhh
仑	kwb
摧	her
瞄	fbb
胧	vz
趋	dqo
挠	hql
煌	xnv
擅	hpb
卒	pku
饼	wsc
狭	pms
丸	mzd
惫	lbn
瞅	fwx
犬	pqq
砖	utz
矣	ovs
楞	scy
昔	udr
裳	djy
骆	rog
雇	zr
阎	eqy
骷	dxg
鸦	azn
妞	gw
墅	mca
焚	cxh
谱	isd
绘	ykt
梳	stg
肿	vro
魁	gol
耽	fc
擒	hkr
陡	fdo
璋	vsu
茂	biu
蹄	ekz
瞥	wlf
瞳	fkm
髅	ddg
绣	ywv
硕	uty
肺	vnc
兹	syy
炒	xha
邮	gf
弘	ios
嫉	guv
届	ngy
嗡	jtn
娱	gjm
喧	jlb
脂	vwd
膛	vda
沧	okc
疚	uqz
盐	ahc
扁	zyc
搁	heo
茅	bcm
滔	oay
坟	acw
掐	hqy
瑜	vgp
邱	lef
桐	sgm
茵	bgk
苹	bks
旷	dx
翘	qln
郝	anf
蓦	lrm
诈	ira
沫	opm
菁	bqv
粹	dpu
琢	vrz
腊	vud
钦	tnq
喻	jgp
宪	lfk
锻	tht
睹	fae
郊	fhf
饥	wb
侃	mjg
粘	dla
媛	gar
谊	ilk
恳	mnx
厮	wol
锤	txt
凳	tab
淮	or
蔽	bwl
聂	frs
贩	qwr
潭	ouu
翩	zyn
呻	jds
枉	svw
拘	hsj
煮	axh
焉	bex
址	aji
匕	wbb
渗	ooi
览	pke
敦	cul
厦	wtl
蕴	byc
冉	gat
薪	bkl
呃	jwc
峻	eol
荐	buu
栽	uqs
嚎	jcr
汁	ous
傍	mky
秃	wbj
磕	uac
禀	pdl
珑	vzl
坎	anq
邵	mfe
萌	bdv
窄	rra
阮	ftk
蹈	eay
碑	ugu
婶	gld
煤	xys
寓	lbr
栈	seq
滞	oyz
倘	mdj
杭	sp
暇	dnr
狈	pqb
峡	ems
侣	mjj
芦	bzh
蔓	bqm
蒸	bwx
禄	loi
胀	vic
醋	zud
淌	odj
伞	ksu
姊	gqk
钩	tfo
衍	pos
妾	kgn
嘎	jtq
蜀	cf
蝴	cxv
萝	bcx
莽	bpb
弩	gri
祷	lqu
稚	wru
圳	agc
徽	kys
衙	pvj
咸	ime
陋	fnp
奢	ka
罐	bbr
霄	rdv
毙	xxw
汝	ogn
敞	djl
暮	ldr
嘘	jxn
灼	xfz
澜	oes
姗	gyc
倪	myk
挫	hka
咪	jdm
钧	tff
捣	hze
燥	xjs
泳	ozi
眶	fav
乙	wii
澈	otl
焕	xqk
酬	zdg
筷	knk
宵	ldv
缚	ytu
揪	hwx
蚁	czh
喇	jpp
丞	wie
拎	hrl
棠	djs
咙	jzl
梭	sol
哧	jan
棺	sld
璇	vyh
瀚	oun
肝	vkg
敛	gdl
剂	cnp
疤	uob
渔	ozv
嗔	jnt
沮	okq
廖	xni
虏	xil
皓	nfj
勋	jqi
恕	gjn
虐	xow
虞	xjm
综	yl
瘾	ufn
驴	rzh
晒	dux
卦	vhb
迦	ijo
陀	flw
窥	rme
堕	fua
哆	jxx
葡	bft
帖	zla
垫	hma
屡	ndg
鹅	hqz
蛛	cap
盲	pfm
碟	uus
狞	plr
囚	gkr
诊	ik
揽	hpe
裴	pyi
捞	hy
吏	mhi
铮	tqx
萄	bfb
盏	eqc
霆	rvo
喔	jng
贷	mqq
勿	fis
吭	jpb
淘	ofb
辟	njf
蔑	bcz
淹	oku
麒	aoq
喽	jdg
栗	usm
绷	yvv
惚	nfn
桓	seb
坊	ayf
桩	sxa
嗽	jpn
履	nk
璐	veo
菩	bkj
巢	gbs
畜	pyb
兀	luu
樊	chk
锡	tdi
棚	svv
仕	mas
倏	mlp
芹	blj
僻	mnf
絮	gjy
杏	sjk
浆	yxi
瘫	urr
啧	jne
磁	usy
冈	ghi
逮	xio
搓	hie
赠	qvd
胶	vfh
脊	ffv
噩	vdd
绰	yhu
呕	jah
嚼	jau
谐	ixn
歼	xxq
揣	heh
殖	xn
拧	hlr
伺	mwm
霖	rcl
驼	rlw
襄	ydw
衔	ptj
惕	ndi
掷	hsf
卸	bcj
炽	xjt
敖	qpl
惭	npl
框	sav
捆	hgs
眩	fpy
蝉	cvu
谜	ido
炫	xpy
塘	ax
阱	fwj
膜	vlm
亨	ctl
奕	qkd
蚂	crm
猩	pdn
滨	olt
沁	onx
跋	eur
藩	qib
舔	fmh
捐	hjv
歧	ju
隋	fuv
蹭	evd
甄	uam
蜡	cud
嗤	jjc
缸	beg
嬉	gpj
哮	jau
熄	xdn
窍	ree
俞	gvp
豁	lqc
垒	ooa
掘	hng
琦	vkx
屎	ndm
乍	raa
孽	bau
毯	exx
弧	iag
槐	sgo
铠	tea
挟	hms
襟	lcl
梨	wps
嗅	jdp
祁	lfe
纲	ygh
渠	oas
矢	vss
捅	hoe
扛	heg
朽	sek
忖	nuc
匈	fhg
扒	htb
雍	pyr
莺	yzn
侮	mtn
闺	evg
霓	ryk
稽	wdd
斋	che
夭	mtt
沦	okw
揍	hqm
瞟	ful
苟	bsj
琉	vtg
漪	opx
暑	dae
窟	rng
钓	tfz
鳞	zda
瓷	fnm
萱	blb
株	sap
倭	mwg
鞘	zdv
沛	onc
噜	jzd
绞	yfh
颓	wbt
睿	xtf
噗	jnz
唔	jvj
幢	zkm
喀	jlo
诅	ikq
涕	osq
拣	hvh
谣	iab
叽	jbj
葱	bfn
拭	hqe
婢	ggu
铸	tqu
绮	ykx
剿	gbp
胤	kyv
秩	wam
畔	bsh
粥	idi
奎	kvg
绸	ygq
茨	bf
熏	xsh
蹬	eta
诏	ima
岔	tpe
叭	jtb
咆	jfo
滥	opc
梧	svj
垮	ake
澳	osk
浙	ohl
甸	fbt
绯	ypf
诛	iap
鲍	zfo
刁	wei
厥	wsn
蚊	ccw
鞠	zfd
歆	snq
拙	hjg
茗	bxj
眷	mfm
戮	nkq
唬	jxb
骏	rol
扳	hwr
踹	eeh
漓	opr
蝇	cj
擂	hrb
涡	ojr
沌	oej
凸	vei
蚩	jec
酿	zz
唾	jxt
琐	vdq
犀	nif
澄	ota
哉	uqj
猾	pdg
煎	svx
窒	rgi
虾	ceh
蝠	cmb
钞	tha
瓣	faf
唧	jmc
觑	xne
哽	jpg
娥	ghq
婿	ghv
讪	ies
耕	tsw
葫	bxv
暧	dir
浇	oql
嗨	jon
诵	ioe
疫	uts
兢	xkk
箫	kxt
颅	hnt
啼	jkz
绅	yds
杉	sis
嗜	jad
券	mpd
遁	wuo
炯	xgj
霎	rkg
讥	ibj
迭	amo
彷	kyf
觅	aej
娴	ges
抿	hbm
剔	dfp
稻	way
敷	tyl
泻	oce
怠	ojn
龚	zut
绒	yqu
讳	ihw
勺	fzd
函	wig
喳	jsb
颂	tot
搀	hzf
撩	hkh
擎	bsh
巍	ewo
脯	vtf
镶	tyw
寥	lni
漾	oii
缴	ynl
藉	btd
弊	wlb
逞	jvo
膏	cvy
戳	nrq
呛	jkc
凹	gei
叩	jcj
禽	kp
懊	nsk
懈	nqf
蛟	cfh
亢	pbj
呸	jje
芊	bxq
慑	nfr
跺	ebs
跄	ekc
蚀	wcc
栖	sux
蔚	bnu
铲	tkw
坪	aks
筝	kqx
顷	wty
腮	vbn
踉	ezm
狰	pqx
踱	exr
嗖	jyr
苑	bxc
秉	wow
猿	pa
堤	adh
佟	mlf
悯	nec
唠	jyi
憨	wfn
肘	vuc
拇	hnm
僚	mkh
霹	rnf
婕	gxh
禹	ajr
啃	jjv
匀	ffb
晖	dcp
怅	nic
聋	zf
拯	hwe
忿	tpn
韧	hpz
邹	qof
梢	sdv
肋	vil
窘	roj
嵌	eyn
婪	cgn
辖	pl
浦	otf
炭	eux
曦	diq
簇	kyv
螺	cby
酱	yxz
屯	ejc
悴	npu
匡	avw
冀	ywt
橙	sta
倔	mng
陕	fms
筱	kml
叱	jwb
髓	duo
淳	ocu
矜	crw
詹	qwi
菱	bal
芷	bji
惺	ndn
浊	occ
囔	jfy
朔	sjv
憔	nrx
睫	fxh
睬	fic
鸽	gzn
臀	nuv
吨	jej
笙	kns
戟	udq
沼	oma
谍	ius
昕	dlj
蛊	ccm
煜	xdk
祀	los
罡	cbe
伶	mrl
荫	bfv
酥	zwh
懦	nrh
厄	wcj
峨	ehq
轴	pgy
伽	mij
雳	rwi
卵	yll
捶	hxt
檐	sqi
棘	nnb
嗣	jym
钗	trz
袜	lpm
妩	gcu
炕	xpb
偎	mby
窦	ruk
蝎	cdp
溶	olc
幺	yyy
膨	vpi
峙	ews
缉	yjf
徊	kdh
呗	jqb
衅	ach
砂	uha
舵	llw
昼	nzb
迸	sco
斟	owl
舆	ypt
椒	sir
靓	qve
旬	fdr
厘	wml
窑	rbf
萎	bwg
涟	opo
疙	utw
芠	bcw
瘩	ubg
梵	cbz
靴	zmw
侥	mql
匿	abu
挚	hmh
镯	tcc
兑	vke
尧	qlu
徘	kpf
芽	bay
狙	pkq
闵	ecw
辫	fyf
瀑	odi
嗷	jql
庐	xzh
芯	bnx
禾	whh
澎	opi
邢	cfe
绊	ysh
蜘	cvj
憎	nvd
靡	xcp
褚	lae
湛	oow
蒲	qtf
嚓	jll
珂	vxk
崽	ebn
贬	qab
惮	nvu
婵	gvu
嗒	jbg
悸	nwu
晦	dtn
涅	oml
恬	nfs
慷	nxi
穹	rig
渣	osb
屉	nuw
缭	ykh
绢	yjv
嬴	pjg
袱	lmp
黝	syi
袅	zyi
淇	ooq
茄	bij
寅	leg
赦	anl
悻	nai
祟	jgl
榻	sdn
蛙	cvg
苇	bhw
嵩	ecg
茉	bpm
唰	jnp
咏	jzi
凿	nig
粪	dut
噪	jjs
菌	bgw
蝙	czy
庶	xux
邸	yvf
晟	diw
禧	lpj
攒	hfq
旱	dkg
虔	xcw
琛	vcs
榴	syb
漱	opn
忑	ehn
匣	agj
忐	inx
谬	ini
蟒	cbb
棱	sal
钝	tej
悚	nps
廓	xcf
惘	ngp
漉	oal
蟹	qpc
佬	maw
曳	dwa
赎	quk
壤	ayw
忡	nro
倡	mdd
冶	foj
姝	gap
筠	kaf
竿	kkg
蜷	cmc
癌	uje
嘈	jyd
蚕	mcc
剖	kjp
颁	tpt
缀	yrr
汀	ord
谕	igp
牡	fat
斐	pcw
懵	nbf
皙	sln
缪	yni
蔷	bad
诫	iqb
恤	nac
咄	jjg
馒	wqm
矫	vmn
痞	ujj
橘	scj
氧	tiy
贿	quv
肮	vpb
瑾	vzt
璧	njl
烙	xog
攘	hyw
攥	hky
汰	okz
溺	oif
铅	tbj
咔	jih
芭	bob
戎	quy
褐	ldp
巩	ebz
吆	jy
彰	sui
漩	oyh
聆	frl
蒜	bll
棕	sll
鹃	jvz
帜	zjt
鄂	def
搐	hpb
蔼	bip
怦	nks
穗	wtn
亩	pbt
撰	hot
绎	yrh
牟	ofn
咨	fnj
奄	kud
梓	sfx
绚	yfd
阀	emq
烘	xut
炙	vxh
翎	rnv
惋	nlc
驯	rgc
栩	snv
逾	gvo
墟	axn
鬟	icy
茬	bua
褪	lmo
鑫	ttt
骸	dph
峭	edv
缅	ytm
灶	xat
洽	ogh
祯	lhq
暄	dlb
裔	ygj
韶	sma
缎	yht
砚	uej
锥	tru
辙	ptl
惦	nxl
铛	tdo
枣	nfb
桦	smu
邃	rso
橱	swu
搔	hrc
腑	vxu
萤	ycc
枢	sah
遏	dfo
募	lil
憬	nxj
庵	xku
叼	jwe
嫖	gul
苛	bxk
锣	tcx
蹑	efr
拌	hsh
奠	zkd
秽	wex
殴	aht
喋	jus
糙	dfo
貂	pma
揖	hjf
葵	btm
榆	sgp
颐	ety
皂	nvq
眈	fck
扼	hwc
眺	fkf
孜	ulx
簌	kpn
玺	qhl
偌	mbu
蹿	err
蓓	bmj
弛	idy
庇	xxb
檀	spb
枭	zs
螂	czf
趾	eji
崭	epl
妲	gbd
掂	hxl
醇	zcu
掺	hoi
驿	rrh
槽	syd
惬	nas
镰	txn
抡	hkw
憧	nkm
删	ypd
鸳	xcz
酣	zyg
宦	lec
筐	kav
琅	vzm
瞻	fqi
焱	xxx
飙	pph
湃	ohq
俨	mew
跷	eql
栅	syc
撅	hwn
煽	xzn
呱	jag
缰	yee
猝	ppu
衮	yto
肴	huv
殆	xoj
谴	ico
蔬	bhg
飒	kbh
婧	gqv
阐	evu
荧	yxh
侈	mxx
霏	rpf
瘟	udc
芜	bcu
俭	mgd
崎	ekx
亥	phh
俐	mwp
屿	eee
譬	nji
饺	wfh
垄	zat
畴	bq
杠	seg
鬓	ilt
讼	ito
晏	dlg
弈	qbc
鞍	zlg
瘸	uik
钮	twa
珏	vlv
钰	tlv
傀	mgo
噔	jta
驭	rry
靶	zob
萦	yys
韬	hay
恙	inx
懿	fan
竺	kte
吝	cjk
羁	czr
荀	bfd
癫	un
嘭	jpi
菇	bgx
恃	nws
瘪	udw
儡	mbb
踌	equ
呦	jyi
榕	slc
昵	dnw
躇	eba
烬	xnf
啰	jcx
酌	zfz
丙	ern
涎	oao
哒	jko
冽	fxp
鸾	qzn
砌	uvp
烨	xmu
翟	nru
辗	pny
噎	jfa
驹	rsj
噼	jnf
咎	lhj
亵	yhz
陨	fjq
蠕	crh
冕	dzk
雌	jwr
茸	bfe
瑛	vbk
剃	sqp
掰	hth
蹙	iie
橡	szx
佯	miy
笃	krm
崛	eng
勘	owi
稼	wlr
桀	xas
渝	ogp
拚	hob
汐	oxx
锈	twv
磅	uky
壕	acr
娄	dgn
撮	hdr
玑	vbj
祠	lwm
鹫	chz
娲	gjr
黏	wkl
珀	vnb
睽	ftm
栓	skv
绫	yal
阑	eps
邑	job
瑕	vnr
磋	uie
粟	udm
薯	bca
沪	ozh
讷	irn
岑	erw
炜	xhw
玮	vhw
娼	gdd
迂	euo
伎	mur
鲸	zch
翡	pnv
坝	aqb
铐	tae
洼	ovg
蹊	eak
寐	lyp
肾	prv
鸯	gkz
這	iod
敝	wlx
涧	oed
崆	ere
甭	jey
笠	kkl
扈	zjo
哝	jcy
芮	brn
卉	ubc
靳	zlj
诬	iek
札	swe
婊	gqy
裘	iyi
扉	zpf
疮	ukc
巅	ent
坞	azu
膳	vij
剌	ppd
鳄	zde
捺	hkl
悼	nh
茧	bcc
毋	nuu
曙	dca
馅	wqy
簸	koz
忒	qnx
妳	gqh
叟	ycr
拴	hkv
嬷	gxo
稣	zw
痹	ubl
垣	aeb
蛤	cgh
谏	ips
羹	ixk
沥	owi
蛾	chq
瑚	vxv
個	mgx
熔	xlc
惆	ngq
雏	qor
饷	wsj
拗	hyi
燎	xkh
熠	xnn
薰	bxs
蕃	bib
捋	hau
籁	kpq
髦	iem
飓	bht
簿	kou
迢	mod
汩	odr
闸	egj
狩	plu
鲨	ohz
蜥	csl
惴	neh
胯	vke
侨	mmn
劭	mil
烹	ctx
咣	jdl
攸	mlx
锄	tki
硝	udv
颔	rwt
鸥	ahz
滕	vmi
寰	lcy
紊	cys
蕉	brx
稠	wgq
蟆	clm
垢	awm
楷	sxn
炊	xnq
忻	nlj
炳	xer
腆	vyt
褒	yms
酋	zqq
赃	qxa
拈	hla
抒	hcv
孰	cuz
袄	lmt
褂	lvh
孺	urh
胭	vgk
赘	qpq
嫡	gkx
礁	urx
珉	vbm
啜	jrr
钳	tyg
晾	dch
茎	bre
隧	fso
窿	rfn
骋	rge
嫦	gdz
槛	spc
掳	hxi
莞	blk
瓢	ula
曜	dnr
锯	tnx
猖	pdd
遐	nto
蹋	edn
飕	bhr
麾	xce
渍	one
猥	pby
篝	kwa
殉	xfd
枷	sij
蜒	cao
皎	nfh
霁	rcn
诩	inv
窖	rfj
咫	nzt
檬	syr
乒	lea
奚	ayk
淤	oyf
溯	osv
凋	fgq
纺	yyf
篱	kpr
泌	ona
刨	fop
樵	srx
忏	nxq
盎	gkc
戾	zpq
咀	jkq
屹	etw
挎	hke
羔	ixh
殃	xgk
庚	xok
淼	iii
淀	olh
隘	fsc
绛	yla
缨	yqg
焘	qux
璨	vxd
跤	efh
锵	tyu
摁	hgn
痊	ukv
嫔	glt
來	skk
臻	gqw
泯	obm
糜	xcd
睦	faa
喵	jbb
缥	yul
褥	lzu
魇	wpo
汶	ocw
馋	wz
渎	ouk
蜿	clc
抠	hah
诶	iov
墩	acl
棣	sxi
沓	idr
喏	jbu
诲	itn
琶	vvo
缈	yfa
缔	ykz
酝	zty
耷	kfe
弼	iui
柬	psb
浏	ocp
拷	hae
剁	bsp
柿	spz
琵	vvx
沂	olj
蕙	btn
捻	hrn
帛	nzj
柠	slr
饵	wfe
撂	hbo
娓	gne
乓	lez
轲	pxk
髯	iga
娉	gge
圭	vgg
璀	ver
苔	boj
肪	vyf
吮	jok
瞩	fnr
啄	jrz
帷	zru
箍	khz
蟑	csu
炖	xej
梗	spg
捎	hdv
瞿	ffr
嗬	jbx
蘑	bxu
唏	jhz
鹊	udz
矶	ubj
羌	iwe
骼	dog
筛	kpz
鲤	zml
羲	iwq
祺	loq
馈	wcq
伫	mle
羿	nbc
苞	bfo
犁	wpf
铎	trh
啬	asd
舷	lpy
矗	nnn
癖	unf
掣	fzh
匾	azy
谧	inc
瀛	opg
珞	vog
衲	lrn
毓	tng
恺	nea
纬	yhw
惰	nuv
嘤	jqg
诣	iwd
谛	ikz
藻	qjs
啷	jzf
佘	kls
黠	sqj
饲	wwm
虬	cwe
涤	ols
骡	rby
钵	tse
邯	yfe
笋	koa
瑀	var
芥	bkn
醺	zxs
佼	mfh
舜	ixa
龌	ang
簪	kcd
痰	uxx
蹂	ecs
恻	nqp
簧	kug
甥	nbi
腼	vtm
驮	rkd
缤	ylt
潺	onu
獠	pkh
筏	kmq
锭	tlh
阙	esn
粤	sde
瞌	fac
髻	iqj
琏	vpo
龊	aeu
椎	sru
唆	jol
煦	dsx
嵋	enf
幡	zib
翌	nkl
毡	ela
碳	uex
鸨	wuz
闽	ecc
躏	ebr
蜓	cvo
咻	jms
捍	hdk
睨	fyk
鼾	dbk
桔	sqj
娆	gql
抉	hak
玟	vcw
蜻	cqv
徨	knv
嗲	jtx
碾	uny
哐	jav
粼	dxg
啐	jpu
谑	ixo
嚏	jfh
甬	oey
鳖	wlz
榨	srr
倜	mgq
稷	wbl
妤	gcv
篡	kfo
晤	dvj
肇	zlx
咂	jaz
帚	ocz
瘤	uyb
瞠	fda
嚅	jrh
怆	nkc
镔	tlt
撵	hmp
裆	ldo
腺	vni
骁	rql
坷	axk
箐	kqv
螃	cky
冢	crz
锢	tgx
晁	dkf
濒	ojt
蝗	cnv
烽	xlq
辘	pal
莘	bfx
撬	hee
澹	oqi
瓮	tom
亘	ebd
钊	tpd
篓	kdg
缇	ydh
宸	lzc
泓	oio
鞑	zko
胄	gvy
羚	irl
绥	yag
笺	keq
荤	ypc
迄	two
踞	enx
桨	yxs
慵	nxe
噤	jcl
幌	zdl
荻	bpx
跚	eyc
袒	lbd
浣	olk
榄	spe
痪	uqk
荼	bkw
晗	drj
阉	eku
腋	vpl
骰	dts
曝	ddi
涮	onp
踵	exm
炬	xaa
涣	oqk
俟	mov
皑	nea
瞑	fcf
渲	olb
擞	hdl
赂	qog
湮	oua
麓	cal
铿	tpa
埔	atf
峦	qes
噘	jwn
涓	ojv
掬	hfd
莓	btn
怏	ngk
萃	bpu
呲	jjw
蹒	ebk
鳌	qpz
睐	fps
昱	dkl
旌	ytn
摞	hby
們	mem
吠	jpq
濮	omz
卞	phb
琬	vlc
谙	isy
啕	jfb
轶	pam
搪	hxj
陇	fzl
纨	ymz
膺	xmv
皋	nku
霭	rip
呓	jbw
橄	swl
纶	ykw
垛	abs
嗫	jfr
盅	rcm
拄	hzv
踝	ebs
臧	iec
淅	osl
岌	erj
岱	mqe
璞	vnz
缄	yim
秧	wgk
翱	nkn
卤	lhi
逅	wmo
靥	wpt
磐	ltu
壑	xca
斓	ces
翊	knv
挛	qhs
琰	vxx
叁	oko
佗	mlw
阖	eac
戬	enq
怂	kkn
汲	orj
垠	amg
迥	gjo
咛	jlr
邂	qpo
杞	saj
痘	uad
臊	vjs
藕	btr
湄	onf
媲	gsx
癞	upq
辄	pfw
獒	qpp
恪	nog
砾	uyh
痉	ure
吒	jav
蜕	cvk
椰	sff
仨	mos
纣	yuc
馁	wag
镐	tcg
蜈	cjm
窈	ryi
說	itk
秤	wks
桢	shq
粱	opd
辐	pmb
悖	nfu
涔	oew
偕	mxn
渭	obv
汴	oph
蜴	cdi
桅	sqc
隅	fbr
卯	ymm
骜	qpr
孚	aui
禺	brn
琥	vxb
阚	ewl
杵	stu
掖	hpl
畸	bkx
晔	dmu
婀	gfx
菡	bwg
噶	jbp
昙	dty
坍	agp
俑	moe
滤	oxn
侏	map
潦	okh
挲	ohh
覃	udu
硫	utg
俸	mqh
蟠	cib
弋	qii
梆	sqf
驸	rmu
馀	wkw
笈	krj
忱	nck
恿	oen
胥	hvy
垦	mat
滢	oyl
窕	rkf
滇	ont
珅	vds
邬	zfe
圃	gtf
咿	jma
徙	kjh
瘴	usu
舫	lyf
嗝	jug
泞	olr
藐	bpk
赣	suq
鹦	qqz
逵	ato
戍	izd
榭	sgu
牠	fdy
揩	hxn
熹	pjx
蟾	cqi
霾	rpm
蔫	bbx
跛	ezp
岐	eur
脐	vcn
糗	ddp
螳	cda
哺	jtf
鹭	eoz
蚣	cto
炀	xwi
嵬	ego
褶	lnn
恸	nti
隽	rvn
飚	bhx
玥	vvy
籽	dui
釜	tht
剐	jrp
鸠	mzn
磷	uda
沒	ofr
娑	ohg
谄	iqy
巳	oss
恣	fnn
猬	pbv
酪	zog
溟	ocf
丕	jei
隼	rus
峒	egm
芋	beu
觊	eae
旖	ytx
筵	kao
娣	gsq
婠	gld
盹	fej
涸	ogx
劾	pil
颌	gty
趔	dxp
殇	xti
噌	jvd
轧	pwe
沽	oxg
愫	nqy
鸢	qzn
龇	ajw
玷	vla
掸	hvu
趄	dkq
溥	otu
疵	ujw
皖	nlk
邺	nfe
杳	sdr
聿	xvv
镀	txr
祎	lhw
鹉	eqz
匍	ftf
崴	eig
岖	eah
幔	zq
蝈	cgl
雒	oru
镑	tky
臆	vsn
偃	mag
蜗	cjr
瞰	fwl
侬	mcy
郸	vuf
搡	hrs
缆	ype
袂	lak
楮	sae
麼	xcy
诠	ikv
洵	ofd
犊	fuk
摹	lhs
蟀	cpu
邋	gyo
瓒	vfq
苻	bmu
荦	yfn
竣	kol
骥	ryt
泗	ocs
痣	uan
贲	ubq
胴	vgm
潼	okm
弑	hse
匐	fmb
姣	gfh
谤	iky
蘸	bzx
蟋	cin
渥	ong
浒	oiu
蛐	cyq
阂	eph
糯	drh
愠	ndc
嵇	wde
谒	id
绾	yld
舀	ayj
呤	jrl
噙	jkr
槟	slt
嘣	jev
诃	ixk
宓	lna
脓	vcy
樟	ssu
忪	nto
蛰	hmc
咤	jlv
捱	hwv
阜	adu
峥	eqx
濡	orh
遢	dno
瑙	vgh
碉	ugq
荃	bkv
孵	yau
讹	imw
嗵	joo
彝	odb
颀	lty
苓	brl
咝	jyy
臾	ykr
篆	kor
椭	sfv
沏	ovp
颦	jhu
蛆	ckq
淆	ohv
揄	hgp
嗑	jac
辎	pgb
踮	exl
犷	pxg
荔	bii
鳅	zwx
會	gdd
闫	eos
徵	kvw
隗	fgo
渤	ofi
馍	wlm
锏	ted
楣	snf
蜃	zcc
遛	ybo
倌	mld
氤	tgk
戌	iei
嶙	eda
馗	msd
匮	acq
揶	hff
胚	vje
啻	kzj
敕	plx
夙	bxd
珈	vij
锹	twx
跂	eur
摒	hnc
迩	qho
啾	jwx
峪	ecg
靼	zbd
菠	qzp
蓟	bzp
沅	otk
馥	wdl
槌	sao
燮	ixr
褛	ldg
為	zax
贻	qoj
礴	uqu
豚	vrs
氲	tdc
湍	oeh
腌	vku
蚱	cra
殡	xlt
毗	bxb
耙	tso
诽	ipf
褴	lpc
恁	mvn
呷	jgj
蚌	cqf
瘁	upu
铝	tjj
蔻	blx
憩	fdn
锚	tbb
濑	opq
耘	tst
俾	mgu
鬃	ill
裟	ohy
祢	lqh
苒	bga
蘅	bpk
鱿	zdy
唷	jtv
傥	mdk
袈	ijy
豺	pua
町	brd
掇	hrr
坯	aje
阏	eyf
戛	tqg
贮	qle
塾	cua
剽	ulp
孬	jgu
衩	lrz
镣	tkh
戊	iuu
犟	ijf
酉	zyy
夥	bsx
斡	udl
過	djo
珩	vpx
匝	azj
诘	iqj
攫	hfr
潢	oug
黔	srw
臃	vpr
罂	qqb
轼	pqe
酗	zhg
嘹	jkh
時	dws
阪	fwr
璎	vqg
冗	cbj
桧	skt
闳	euo
皿	cmm
囡	ggn
辍	prr
觎	gve
浚	ool
闰	evw
臼	yjj
蹩	wle
煲	mjx
怵	nsz
囤	gej
罔	gsp
蚓	cic
碴	usb
姒	gwk
灸	qzx
蚯	cle
嗥	jnu
堑	pla
箴	kim
谗	izf
嵘	eys
箩	kcx
艮	mgg
碱	uim
葆	bms
還	cmo
旎	ytw
谆	icu
粽	dll
牒	yus
泸	ohn
蔺	ber
刽	ktp
锷	tde
诋	iyz
惇	ncu
缜	ynt
爻	hhi
贰	qtq
坳	ayi
睑	fgd
葭	bnr
昀	dff
經	yee
噫	jsn
妪	gah
镂	tdg
癸	tmt
沣	oqf
笆	kob
壬	vww
绉	yqo
抨	hks
箕	koq
叵	ajk
坨	alw
颉	qty
姹	glv
赳	dcj
琮	vll
焊	xdk
淬	opu
纭	yty
埠	aau
泱	ogk
恹	nwp
淙	oll
榛	sqw
酵	zau
銮	qtj
孛	fui
嗳	jir
佶	mqj
犒	fcg
茱	bap
饪	wvw
孪	qui
泠	orl
砺	uwp
遽	xro
嗟	jie
钙	tew
鲲	zdx
谚	iki
闾	ejj
谟	ilm
馊	wyr
翦	svn
雉	vru
虱	wac
糠	dxi
锴	txn
赈	qzc
骠	rul
旮	mdr
峋	efd
跆	eoj
飛	wfn
瘠	ufv
潸	ocv
饕	jew
佚	mam
淄	ogb
谀	iyk
镳	tax
廿	unn
喟	jbv
偻	mdg
绺	ylj
沱	olw
囱	slx
铳	ttk
袤	ycm
兖	fok
對	niu
栾	qsm
畿	yyb
诌	iqo
赓	xoq
苯	bse
佻	mkf
繇	aby
魈	gov
屌	njz
谲	icj
泾	ore
獗	pwn
鞅	zgk
蹶	ewn
绔	yke
雹	rfo
旯	dmj
洱	ofe
樣	sii
馄	wdx
粲	xrd
哂	jux
蔗	bxx
饨	wej
奘	yak
芍	bfz
淞	oso
腴	vyk
現	qfk
剜	lxp
汾	otp
顼	vty
濂	oxn
蜚	pcc
殒	xjq
麝	agu
鹞	abz
蚤	rzc
浃	oms
坂	awr
颚	det
忤	ntu
洙	oap
祗	lyz
無	cuu
迤	tdo
眦	fjw
彗	qqo
暹	dro
赧	anr
佝	msj
蒯	bvp
郦	evf
僮	mkm
钺	tiu
嘞	jzi
硅	uvg
玳	vmq
蛹	coe
睾	aci
螭	cpr
赁	mvq
盂	euc
瑁	vdf
俅	miq
侗	mgm
骛	clr
宕	lus
纂	kfy
堰	aag
厩	wmc
萋	bxg
鄢	bef
帔	zzp
蓁	bqw
杈	srz
熨	nlx
挞	hko
觐	zte
開	eck
阗	ent
钏	tgc
煊	xlb
泫	opy
迳	reo
夔	sdl
缮	yij
燧	xso
嘁	jih
孱	nuu
懑	obn
邕	gjo
彧	qim
柩	saz
耆	awd
漕	oyd
鹄	fjz
龛	gzl
饯	weq
餮	xkw
幄	zng
鹘	dzn
爰	aer
噻	jla
倨	mnx
汜	oos
诙	iux
锃	tjv
颧	bdt
璟	vxj
纰	yxb
绡	ydv
鏖	atj
瞭	fkh
氢	tre
颢	xty
楔	sqk
藜	bwi
郢	jvf
妫	gzz
栀	swc
岫	egy
谥	isc
骧	ryw
犄	fkx
葳	big
辇	mmp
珪	vvg
魑	gor
璜	vug
聒	ffs
椿	sqd
谩	iqm
伢	may
琊	vaf
骅	rmu
鹜	clz
禛	lnt
闩	eei
颍	wit
翕	gnv
濠	ocr
仞	mpz
鳗	zqm
玖	vqz
踊	eoe
皈	nwr
骊	rev
痿	uwg
芑	baj
孑	tei
帼	zgl
撸	hzd
檄	snl
啵	joz
昶	zid
柚	sgy
祐	luy
篑	kcq
陲	fxt
潋	ogl
亟	tje
樽	szu
遨	qpo
锺	txm
舶	lnb
莆	btf
蛀	czv
琨	vdx
點	sla
邈	pno
棂	sox
抻	hds
搽	hbs
俪	mev
铉	tpy
怩	nnw
嚯	jrr
茁	bjg
韭	pei
膘	vul
酩	zxj
榔	szf
娩	gzk
忸	nwa
刎	fip
彿	kin
扪	hem
漳	osu
呶	jgr
瑄	vlb
仃	mrd
呯	jks
佞	mtg
饬	wti
裨	lgu
壹	fad
黜	sjg
巽	oot
鹂	evz
滂	oky
徉	kiy
戕	yqg
埂	apg
倢	mxh
僖	mpj
纫	ypz
奂	qgk
溉	omc
範	kpc
猊	pyk
胛	vgj
卟	jhb
锌	tfx
遑	nvo
跻	ecn
珣	vfd
妗	grw
蒿	bcg
钛	tkz
岷	ebm
葩	bno
傕	mcr
磺	uug
魃	gor
汕	oes
蠡	orc
苋	bej
剎	hsp
肛	veg
潞	oeo
阕	etm
铤	tvo
桠	sen
涿	orz
薜	bnf
郃	gfe
氐	yvz
鲛	zfh
睥	fgu
滦	oqs
稔	wrn
頭	aty
妺	gpm
锲	tqk
徜	kdj
哙	jkt
冼	ffk
獐	psu
讧	ieg
喙	jor
氨	tlg
缯	yvd
褓	lms
赊	qkl
菀	blc
鄱	ibf
炅	dxh
碜	uoi
戗	kcq
嫫	glm
瓴	rmw
犍	fxo
酊	zrd
臌	vpr
钠	trn
螓	cqw
镌	trv
麗	eva
铀	tgy
羯	idp
挝	huo
谡	ibl
邙	pfe
襁	lic
渚	oae
胫	vre
箸	kae
逖	pxo
雎	kru
砥	uyz
衢	pfr
狒	pin
骞	lwr
荟	bkt
汛	owu
盥	yic
睚	fwv
栎	syh
祚	lra
砣	ulw
烩	xkt
氣	tdm
夯	kil
拮	hqj
驷	rcs
掴	hgl
蘩	bty
禩	lbt
蜞	coq
乜	wwe
灏	oxt
殓	xgd
發	tit
哔	jxu
擢	hnr
殛	xte
荪	buh
徇	kfd
蹴	ecd
忾	ntq
谯	irx
鸵	zlw
疹	uki
韫	hdc
祛	lao
膻	vpb
黢	sol
仄	wkr
唳	jzp
炁	cxh
烊	xiy
孀	grf
斫	ulj
腚	vlh
牍	yuk
佃	mbt
懋	scn
赡	qqi
鹗	dez
秣	wpm
榷	scr
镭	trb
铄	tyh
庾	xyk
媾	gwa
嫒	gir
饽	wfu
佥	gdd
谌	iow
尕	vhx
啮	jac
蝼	cdg
闱	ehw
篙	kcg
逡	oto
膑	vlt
問	ejk
荥	yis
隍	fnv
蕨	bwn
罄	anb
郓	cpf
囵	gkw
橹	szd
诰	ifj
蹇	lwe
睢	fru
喱	jwm
縯	ylg
間	edr
話	ifs
肓	pvy
榈	sej
绶	yir
罹	cnr
槊	sjs
瑗	var
槁	scg
秸	wqj
裱	lqy
牦	fem
荑	bki
滓	olf
腓	vpf
谶	ike
砝	uao
舐	fyv
嗎	jrm
秆	wkg
荏	bmv
邝	xfe
芈	bhs
給	ygh
斛	qld
暨	mcb
狻	pol
滟	oqo
恫	ngm
麋	adm
纾	ycv
锟	tdx
粑	dob
诳	ipv
氅	dje
寮	lkh
鹑	cuz
驽	grr
囫	gfi
炷	xzv
缙	yed
徕	kps
弭	ife
聲	anf
橇	see
痢	uwp
撺	hrr
柑	syg
圜	gcy
儆	mbl
魉	gok
妊	gvw
婳	geg
兩	ezk
矍	ffr
犸	prm
哓	jql
酶	ztn
當	djb
庖	xfo
缢	ysc
俎	kkk
墉	axe
鲫	zmc
藓	bzi
佰	mub
痔	uws
觥	qdl
闇	esy
哞	jof
旃	ytp
讓	iyw
伉	mpb
猷	zpq
怄	nah
牯	fxg
茀	bin
烜	xeb
锨	tln
長	eii
豢	mrs
轱	pxg
泵	uis
擀	huk
蝌	cwl
绻	ymc
呔	jkz
绌	yjg
蓑	byt
纥	ytw
釉	igy
翳	avn
殁	xts
讫	itw
濛	oyr
從	kkh
蜇	hlc
砧	ula
殄	xki
萼	bde
覺	yhk
辔	ypj
诮	idv
胰	vki
蜍	ckw
浔	oou
緂	yxx
钜	taa
瘌	upp
趿	erj
瘀	uyf
鸪	xzn
霰	rul
婥	ghu
赟	ceq
邊	dro
祇	lyv
鹧	xuz
诨	icp
掼	hnq
僭	mcd
礽	lvn
動	xmi
弁	obc
體	dya
湎	otm
蹉	eie
汨	odr
栉	sbc
醍	zdh
磬	anu
铂	tnb
蓼	bni
泷	ozl
梏	sfj
祜	lxg
摺	hnn
鸩	ckz
虺	lcc
豌	alc
嘬	jdr
疡	uwi
杲	dsm
荞	bmn
煨	xby
蛔	cdh
涝	oyi
焖	xen
祉	lji
魍	gop
锉	tka
跎	elw
桎	sgi
娠	gzc
诿	iwg
喆	qqj
瓯	ahm
偈	mdp
殚	xvu
镁	tik
邳	jef
胱	vdl
痂	uij
刍	qow
醐	zxv
糅	dcs
亞	eny
岿	epo
愎	ntl
赝	wmq
禇	lae
笳	kij
唁	jiy
齑	cne
崂	eyi
狎	pgj
踽	ear
揆	htm
鳍	zad
钹	tur
侩	mkt
帧	zhq
裾	lnx
椁	scu
姮	geb
唿	jfn
種	wxm
澍	opu
崧	eso
淩	oal
衾	rwy
骈	rsc
仟	mxq
勖	dfi
咭	jqj
羸	pji
谪	ikx
柁	slw
窣	rpu
狲	puh
槃	lts
珲	vcp
蛭	cgi
痍	uki
俦	mqu
猢	pxv
镫	tta
戡	owq
鼹	ydg
悌	nsq
嬅	gbh
濯	onr
莅	bmk
懔	npl
裡	lml
肊	vwi
咩	jiy
誊	miy
見	fke
卻	ccj
鳝	zij
韪	dhh
噱	jxr
嫪	gni
亓	elu
铩	ths
燏	xcj
硌	uog
俚	mml
椤	scx
脍	vkt
臉	vgk
汞	eis
淖	ohu
炘	xlj
姘	gsc
聩	fcq
泅	ogk
喑	jsy
绦	yls
铡	tqp
桫	soa
恽	ncp
薏	bsn
遒	zod
痨	uyi
蚪	cld
屙	nfx
佫	mog
窸	rin
蒺	buv
蚡	ctp
觞	qti
葺	bjf
煅	xht
悱	npf
茕	ywu
肜	vis
沨	obh
棫	sqm
靛	qvh
诓	iav
拋	hdi
忝	mhx
箔	kon
璠	vib
芃	bbz
別	jap
珥	vfe
菅	bld
嶷	ewh
酃	rdf
與	yet
岬	egj
臬	dsm
舢	les
肱	vuo
焙	xkj
逦	evo
啖	jxx
冁	vuy
鸷	hmz
蜢	cuc
莠	bwv
級	yrj
茔	yat
铨	tkv
槚	suq
胺	vlg
旻	dcw
雲	rty
變	iyl
堇	zte
艽	bmj
湟	onv
瑭	vxj
踅	hle
芨	brj
逶	wgo
嶂	esu
幾	yyk
钾	tgj
跹	exo
徭	kab
鹌	kuz
狍	pfo
笞	koj
埙	ajq
仵	mtu
缛	yzu
椽	sor
暝	dcf
苕	bma
酮	zgm
貉	pog
婺	clg
玠	vkn
糨	dic
囿	guv
铖	tiw
畹	blc
帏	zhw
镝	tkx
缦	yqm
铣	tfk
轸	pki
舂	qyj
將	yvu
碘	uyt
黍	wki
芫	btk
馔	wot
碁	ous
铢	tap
槿	szt
赭	ana
涪	okj
塬	awh
氯	toi
倬	mhu
酡	zlw
實	lnt
傣	mqi
颏	pty
缱	yco
媞	gdh
浜	olt
暻	dxj
篾	kcz
鋆	aft
柘	sus
猕	pih
桉	slg
砒	uxb
邶	ywf
洌	oxp
衿	lrw
颛	eht
蜮	cqm
骢	rsn
柒	ovs
呖	jwi
郅	gfe
饴	woj
圩	aeu
茯	bmp
疱	uf
圄	gvj
琚	vnx
橐	fus
钿	tbt
枸	ssj
貅	pms
蛎	cwp
嫱	gad
爿	ypp
進	rod
辂	pog
綦	oys
唢	jdq
笤	kma
旸	dwi
鼬	ygy
苜	bfm
窠	rbs
嗄	jtl
卅	bcc
茏	bzl
艄	ldv
苡	bwk
辚	pda
囹	grl
撷	hqt
伥	mic
毐	anu
疟	uow
骓	rru
筌	kkv
屐	nkr
猁	pwp
靈	rdk
傩	mrr
帶	bcz
疽	ukq
珙	vut
貊	pub
诟	iwm
剛	gsp
鬣	igy
鼐	vfy
獭	ppq
嗞	jsy
獾	pbr
洮	okf
邛	efe
赅	qph
黒	shh
擤	hdl
稗	wgu
咴	jux
楂	ssb
氮	txx
竽	keu
箓	koi
勐	uci
谔	ide
碣	udp
铧	tmu
逑	iod
郾	adf
铆	tym
師	adz
褡	lbg
滁	ofw
陂	fzp
喁	jbr
矠	cud
湫	owx
蚺	cga
钨	tz
钲	tbe
綮	zly
噹	jdb
蕲	bvl
遴	dxo
舛	xay
荠	bcn
玕	vkg
稞	wbs
阄	equ
荚	bms
媪	gdc
鎏	ott
笏	kfi
迡	nwo
悒	njo
晷	dlj
郗	huf
宥	luv
戰	dbq
豸	pii
摈	hlt
儋	mqi
葶	bcr
瑸	qlt
愛	inl
凫	zbj
阡	fxq
蚨	cmf
粕	dnb
猗	pkx
纛	qny
畲	klb
睇	fsq
滿	ouk
難	umr
洇	ogk
醮	zrx
裏	yml
虢	aub
龍	eei
癣	uzi
葻	bbc
珐	vao
酆	eqf
內	gkr
诒	ioj
踯	esf
颎	wxt
馏	wyb
莛	bvo
髭	ijw
龈	amg
锒	tzm
钯	tob
楹	svc
贽	hmq
菖	bdd
灞	orv
虻	cpw
苌	bic
聽	fvn
躅	ecc
牝	fwb
钎	txq
珺	voj
畦	bvg
欤	ewn
桁	spx
腩	vui
吖	jsc
該	iph
屍	nxw
蠹	fuc
眬	fzl
夢	bcx
張	iei
瓤	yda
淝	ovo
鸶	yyz
亳	cav
應	xmn
楫	sjf
薨	bcw
訇	fiy
祂	ldy
镊	tfr
陟	fjh
炰	fox
靜	qvx
镗	tda
樗	sre
苫	bla
阆	ezm
莒	bjj
罅	bxu
稹	wnt
豕	rss
涫	old
螟	ccf
骝	ryb
連	pod
蓿	blu
祧	lkf
苎	ble
擘	njh
犴	pkg
玎	vrd
侉	mke
仝	keg
學	yhu
厝	wud
馐	wia
邰	ojf
潍	oyr
兕	glu
赍	fkq
龅	afo
黩	suk
霂	ros
胪	vhn
抟	htz
诤	iqx
鬈	imc
結	yqj
烺	xzm
裝	yay
芪	byv
莳	bdu
毽	exo
筇	kef
猞	pkf
忺	nnq
砭	uab
腱	vxo
澧	oya
挈	qph
怼	run
镞	tyv
貔	psx
嬗	gpb
醴	zya
搠	hsv
杷	sob
薹	bqg
杌	slu
並	sny
風	bac
铬	tog
讴	iah
闼	eko
拊	hmu
歃	xyn
機	syk
輕	pee
蝮	ctl
沆	opb
晞	dhz
飏	bhi
烷	xlk
箜	kre
彀	fei
雠	rir
傳	mtu
荩	bnf
揿	htn
恂	nfd
燊	xxs
茴	bdh
癯	ufr
吔	jdy
備	mue
國	gqm
闿	eea
衽	lvw
鲈	zhn
缟	ycg
紅	yeg
昴	dym
廪	xpl
圻	alj
垓	aph
奁	kah
瘙	urc
痫	ues
黟	sxx
讦	ikg
矾	ubz
铰	tfh
氖	tvn
烯	xhz
葉	bus
陉	fre
耄	awe
妯	ggy
強	ioc
踟	evj
菟	bzz
鲧	zay
镛	txe
峄	erh
镱	tsn
竦	kps
搦	hif
吡	jxb
鳏	zci
飨	yws
猡	pcx
痼	ugx
讣	ihb
荭	bye
龢	gdw
殺	hst
鯶	zcp
馕	wfy
枰	sks
黼	nwt
檫	sll
氂	ple
鄯	isf
鲇	zla
酽	zew
垅	azl
佤	mmw
歙	gnn
骘	fjr
妁	gfz
頫	kft
處	xlb
垩	ena
蠃	pjc
锆	tfj
枇	sxb
鄞	ztf
乩	lwe
幂	cdz
遠	ajo
場	abi
蟊	ccc
沭	osz
綪	yqv
垭	aen
鹳	bdz
萁	boq
伧	mkc
苁	bkk
恚	vnx
盱	feu
鼋	tku
門	emm
钤	trw
矬	vka
帑	grz
關	eyb
車	pcc
兒	yke
劍	gdp
離	phr
轉	ptu
侪	mcn
溦	oel
極	ste
穑	wad
脶	vjr
煸	xzy
娌	gml
砀	uwi
陣	fpc
孳	syu
吶	jgk
蚋	crn
脔	qrk
缁	ygb
箬	kbu
豔	eqc
颙	brt
樯	sad
麂	abj
糸	yss
猱	pcs
跸	exu
甑	vdm
榘	vas
掮	hzv
岈	eay
芾	bnc
龃	akq
趸	epe
沔	oew
涘	oov
炆	xcw
蹰	ewu
苣	baa
冄	gte
裢	lpo
萸	byk
郧	jqf
捭	hgu
緊	ery
嫇	gcf
謇	lwi
湉	onf
笫	kqk
雖	jcr
妣	gxb
枞	skk
禟	lxj
疥	ukn
啁	jgq
氰	tqv
蒹	bsn
驚	bsr
檑	srb
誰	iru
莴	bjr
禳	lyw
缌	ybn
婄	gkj
夤	xlg
鹬	cgz
勣	qfi
玢	vtp
镏	tyb
終	ylf
狯	pkt
馬	rmm
傢	mlr
焐	xvj
縻	xcy
屃	nqb
魆	goi
莜	bml
腭	vde
鲑	zvg
淦	otj
洹	oeb
砦	jwu
荇	bpx
鲠	zpg
蚝	cem
榉	sdh
楝	sps
艨	lyr
楸	swx
睃	fol
鹈	sqz
棹	shu
昇	dab
瀣	oxe
東	pei
龉	avj
鬻	idu
庥	xms
骐	roq
囗	gkk
筢	kho
柝	slz
靺	zpm
堀	ang
膂	ytv
磔	uxs
柞	sra
鞨	zdp
谘	ifj
泔	oyg
锰	tuc
協	uii
聃	fga
徂	kkq
堞	aus
蟥	cug
羕	izi
墀	anf
薅	bgu
呎	jnz
艟	lkm
嵯	eie
怿	nrh
窳	raa
蛳	cpz
彘	oww
迨	ojo
犰	pmj
荜	bxu
篦	ksx
跶	eko
橛	swn
焯	xhu
儁	mrg
趺	emf
倥	mre
鸹	fzn
椋	sch
瞇	fdo
崃	eps
記	iaj
旒	ytg
芡	bnq
芩	brw
請	iqv
耧	tsg
蝺	car
庠	xiy
狴	pxa
钴	txg
侂	mxv
眾	cmk
镕	tlc
樾	sdi
欸	ovn
穰	wyw
螯	qpc
耒	tsm
眙	foj
菈	bhk
罴	cax
隨	fuo
肄	wvx
怛	nbd
缃	ysf
哏	jmg
逄	lao
岙	mes
沤	oah
珰	vdo
荨	bou
娈	qgn
圉	gai
叻	jil
訢	ilj
耋	awg
鸮	jez
邴	erf
雙	rrr
擊	pgh
毂	fpc
俳	mpf
傷	mti
铱	tyi
艏	lsd
喈	jxn
類	dpt
蓠	bpr
薮	bdl
峤	emn
貘	plm
珮	qbz
崤	ehv
笄	kck
缗	ybd
蹁	ezy
蕤	brn
條	mcs
璁	vsn
渑	oju
秫	wsz
掾	hor
吋	juc
祆	lmt
豉	aur
醪	zni
郿	nff
搧	hzn
庑	xcu
茛	bmg
莼	byj
筮	kek
挹	hjo
媸	gjc
阒	efp
怫	nin
鲔	zuv
許	itu
姰	gfd
雱	ryf
認	ipn
疣	udy
镍	tds
團	gtu
褫	lwb
锛	tkb
潾	oda
轳	phn
鲵	zyk
萬	bbr
錯	tud
熵	xkj
馑	wzt
謝	igu
眇	fha
瘆	uoi
電	rud
轺	pma
塄	acy
續	yat
纔	yzz
涞	ops
杼	scv
沖	oro
讬	iav
崮	egx
岘	eej
纮	yuo
诂	ixg
镢	twn
玦	vak
鲶	zrn
氟	tin
鲮	zal
蔌	bpn
椹	sow
鐵	tuv
僜	mta
洄	odh
栊	szl
孢	ufo
郏	msf
沴	oki
郴	cfe
侑	muv
詈	ciy
獬	pqf
澶	opb
箧	kas
興	ygt
語	ivj
嗐	jlj
鳃	zbn
朮	szd
線	yni
矸	ukg
讵	iaa
枋	syf
璺	ygl
幫	vuz
鞣	zcs
澌	ool
啭	jpz
蜉	cau
黻	nwr
鳥	znn
耦	tsr
樘	sda
虛	xny
跖	eus
蛉	crl
箪	kvu
璈	vql
逋	tod
歡	bdn
扦	hxq
孃	gyw
愆	pon
跩	eda
鳟	zzu
泚	ojw
藿	brr
浠	ohz
痱	upf
憷	nch
隊	fsr
殳	tss
葚	bow
纡	yeu
翮	unv
戋	eqg
黧	wfs
喦	jde
錢	tqq
鲽	zus
絕	ypo
诔	its
矇	fyr
曷	dfp
毖	xna
髋	dle
題	dht
狳	pkw
藍	bec
槎	sie
坻	ayz
哚	jbs
蜊	cwp
铙	tql
乂	hii
袆	lhw
嫘	gby
漯	oby
骟	rzn
捌	hjp
瓘	vbr
椴	sht
溘	oac
墒	akj
蹚	eda
阋	eyk
牖	yzt
阇	eae
愍	bln
龋	aar
篁	knv
刈	hpd
蠲	stc
樂	nys
谝	izy
悭	npa
郞	zmf
總	ysn
鬲	ugg
瓠	kea
畠	nbt
撄	hqg
棰	sxt
麸	qlm
圪	atw
洺	oxj
嬛	gcy
錾	plt
笮	kra
轾	pgi
杓	sfz
砷	uds
衛	phw
辦	fif
剀	eap
疴	uxk
餍	wpw
锱	tgb
寤	lyj
糍	dsy
瞽	puf
芎	big
尻	nmj
缡	ypr
捩	hzp
蹼	enz
鳕	zro
陸	faa
裰	lrr
窨	rsy
偬	mfn
唸	jrn
茑	bzn
榫	sru
幛	zsu
峁	eym
蓊	btn
鏊	qpt
秭	wqk
屄	nrx
鲅	zur
瘢	ult
茼	bgm
汊	orz
茝	bec
郜	fjf
芰	bur
旄	yte
殍	xau
樨	snf
碇	ulh
涑	ops
摭	hxx
钡	tqb
凼	igk
垆	ahn
萘	bkl
炔	xak
蟮	cij
蓍	bad
岢	exk
飧	xws
俣	mjm
碓	uru
刿	exp
數	jul
龁	atw
孓	tzd
谰	ies
蕖	bos
痧	uoa
霈	roc
暍	ddp
唵	jku
訴	ilz
叆	tir
钚	tjb
槲	sql
嫚	gqm
腦	vgh
聖	fjv
異	but
铗	tms
亂	aow
绐	yoj
痈	uey
埚	ajr
狷	pjv
媗	glb
層	nvd
酢	zra
阍	eyd
漸	opl
梼	squ
螫	anc
欹	kxn
準	oru
傈	mus
怙	nxg
渌	ooi
榊	sld
壅	pya
赀	jwq
紒	ykn
傒	mak
癔	usn
莪	bhq
冴	fay
嚇	jan
吽	jfn
視	lfk
潆	oyy
腳	vcc
檩	spl
镠	tni
逯	oio
浞	oeu
熱	atx
痤	uka
蔸	bnk
嘚	jku
親	ksk
翥	anv
毬	eiq
菽	bir
鸱	yvz
戲	xaq
昉	dyf
盍	aoc
茭	bfh
黥	sch
酰	zfk
圍	ghw
赉	psq
珽	vvo
藥	bns
霪	rov
菏	qxk
淰	orn
禵	ldt
夠	xxs
柟	sga
诹	ifr
苴	bkq
園	gaz
粳	dpg
滅	oix
溿	obh
復	ktl
蹓	eyb
樹	spu
欷	hun
糌	dld
亶	pdb
惡	enn
義	ihq
趵	efz
舸	lxk
護	ibr
蛩	ebc
枥	swi
決	oak
蘼	bxp
娰	gmk
蕈	buu
搖	hvb
襦	lrh
膈	vug
芏	bat
畈	bwr
笊	kau
艉	lne
燠	xsk
阊	edd
厣	wpg
傧	mlt
鸬	hnz
艿	bvn
攮	hfy
酚	ztp
璘	vda
塍	vma
叇	txo
椟	suk
厶	oss
菰	bua
氦	tph
笸	kaj
疸	ubd
镪	tic
圮	aaj
禤	lcn
佈	muz
幪	zyr
醛	zbv
篌	kmv
髡	ilu
砲	ufo
謦	ani
谖	iar
徼	knl
醯	ztc
懷	nyi
裣	lgd
豽	prn
則	ftp
枳	sjt
蓖	bsx
髫	ima
酯	zwd
較	pfh
暾	dcl
訾	jwi
勢	ati
趕	ddk
確	ucr
繼	yyw
缳	ycy
碛	une
镒	tsc
斷	yyl
孥	gru
硖	ums
溧	ous
柢	syz
镬	tbr
糁	doi
皴	otz
虼	ctw
卺	wic
軍	cpc
箝	khy
鋈	omt
帙	zam
鍪	clt
锞	tbs
蘧	bxo
祩	lap
丌	luu
樓	sjg
簟	kuu
昳	dam
觀	bdk
鞫	zfi
倆	mek
泮	osh
溱	oqw
眭	fvg
寶	lvt
棽	crw
坩	ayg
窫	rqk
嬖	njg
旉	tyf
鄄	uaf
隱	fan
砻	zus
郯	xxf
隰	fdx
報	air
劻	avi
衹	lyv
熜	xsn
單	dbu
廋	xyr
祼	lbs
薙	bvr
約	yfz
筚	kxu
爾	tzh
朐	vsj
尋	oeu
厓	wvg
墼	pga
跬	evg
愀	nwx
識	isq
嘡	jda
毀	yat
醚	zdo
幹	udk
鳜	zwn
萑	bru
缍	yxt
恆	nee
蚧	ckn
遄	eho
達	aio
戆	sun
姽	gqc
麇	awh
柰	sls
琤	vqx
竑	kuo
趱	dfq
鲂	zyf
黃	uet
湣	obd
壞	ayi
螅	cdn
細	ybt
垸	alk
禔	ldh
裎	ljv
煇	xcp
玭	vxb
試	iqe
態	ovn
爔	xiq
埸	adi
務	cli
槠	sia
儇	mcy
靚	qvk
淚	ozp
肽	vkz
顯	dyt
卮	wec
绀	yyg
顸	kty
盉	wcm
筲	kdv
崁	ean
倮	mbs
菸	byf
媵	vmg
弐	eqt
岜	eob
澣	ouk
谵	iqi
褊	lzy
創	rzp
鲟	zou
瘐	uyk
帻	zne
簋	kmc
梃	svo
缵	yfq
礅	ucl
屣	nkh
陽	fbi
缶	bff
墡	aij
亍	kcc
鹚	syz
甪	aey
矟	cdv
煙	xua
缒	yao
塊	ago
刖	vpd
澂	oel
鹡	ffz
炻	xus
卬	ycj
絲	yys
瞋	fnt
焗	xnj
荽	bag
磴	uta
砬	ukl
锶	tbn
鼍	dbu
瘿	uqg
閒	evy
跣	efk
疖	ucj
況	ojk
練	yps
閃	ekr
迓	aod
炝	xkc
鐘	tkm
啉	jcl
硒	uux
擁	hpr
貓	pbb
汔	otw
驺	rqo
蛄	cxg
伛	mah
绂	yur
鞯	zbu
燹	rrx
髀	dgu
缫	ygs
禦	kbl
翀	nro
跗	emu
羖	its
濬	oxf
銎	ebt
凇	fso
羏	iis
銀	tmg
鏦	tkh
襌	ldu
綠	yoi
調	igq
唎	jwp
寫	lyx
爲	aax
殂	xkq
嗉	jqy
铘	taf
鞮	zdh
盡	xec
眀	fvy
饫	wmt
檗	njs
辏	pqm
鼙	puu
璩	vxr
悛	nol
純	yej
彟	our
沚	oji
褙	lyv
殘	xqq
煳	xxv
笕	kej
鲥	zdu
尥	dfz
锍	ttg
劢	epi
淒	oxg
嵊	eww
轫	ppz
饧	wwi
隻	rry
抺	hpw
佾	mtv
鲩	zlk
鸰	rzn
書	xdr
谳	iup
棼	ctp
苷	byg
觚	qag
萏	bqy
熘	xyb
媽	grm
佺	mkv
嫈	xxg
羝	iyz
鹕	xvz
睏	fgs
觜	jwq
號	jeb
喾	dfj
満	obe
蘖	bas
剡	xxp
溫	ogc
響	yzs
譞	icy
爭	axv
椐	snx
鍊	tps
狝	pqh
曩	dyw
麴	skd
瑷	vir
誗	iwp
砗	upc
髁	dbs
領	rty
蚍	cxb
怱	fin
阃	egs
溲	oyr
匏	keo
桡	sql
狺	piy
鲢	zpo
耨	tsu
鋹	tei
煖	xar
豳	err
傑	mxs
燒	xal
舨	lwr
缑	ymv
猓	pbs
愦	ncq
蝾	cys
疋	hff
蹾	ecl
榧	sap
搴	lwh
洫	oac
蚜	cay
員	jft
荸	bfu
磙	uyo
釐	plm
坜	awi
粜	jgd
螈	cwh
轭	pwc
踫	esn
绨	ysq
摀	hzn
庋	xur
抔	hjb
珃	qga
詝	ilr
計	ius
皲	cpz
魚	zvv
胝	vyz
犼	puw
滹	oxu
蕗	beo
铍	tzp
麈	azv
邗	kfe
跏	eij
锔	tnj
蝣	cyu
論	igy
習	nnb
鲋	zmu
誄	its
寔	ldh
網	ygp
柙	sgj
鸫	vhz
罘	cjb
浤	olo
獍	psk
硼	uvv
疝	ues
勰	iin
鹾	lhe
掛	hvh
扃	zgj
皤	nib
潲	owv
笥	kwm
痋	ucc
葸	bbn
鲱	zpf
旰	dkg
燝	xxj
賣	act
溏	oxj
險	fgk
憶	nsn
偾	muq
溽	ozu
伲	mnw
揎	hlb
剞	kxp
禮	lya
秾	wcy
晳	sld
锗	tae
華	beh
悝	nml
漭	obb
痦	uvj
寘	lnt
屬	nic
狀	ypq
桿	sdk
嘏	xnr
樛	sni
袢	lsh
礻	lss
鳎	zdn
嘆	juk
願	wnt
昝	lhd
咹	jlg
滏	ott
釋	ici
薩	bfn
廨	xqf
觳	feq
璔	qvd
綝	ycl
戢	jfq
桷	sqj
舻	lhn
黙	mpx
郛	auf
羅	cyr
彖	ors
袛	lyz
裉	lmg
買	cft
蓐	bzu
脘	vlk
疠	uep
艋	luc
嬲	bii
锜	tkx
綎	yvo
業	nit
獨	pcc
郇	fdf
粝	dwp
參	ooi
歷	wwj
蠱	ccc
厲	wbr
鹩	ksz
耜	tsd
坼	alz
埕	ajv
髮	iur
迴	dod
鹪	rxz
栌	shn
紓	ycv
陰	frt
砩	uin
尜	hkh
宄	lmj
瘊	umv
嫠	plg
蠓	cyr
洳	ogj
筥	kjj
埒	aau
墁	aqm
廝	xol
铊	tlw
愔	nsy
講	iwa
锂	tml
脫	vtk
蔟	byv
蹀	eus
剋	xkp
颟	bet
劬	sil
濞	odl
飯	wwr
飄	ulc
曈	dkm
醫	avz
誘	iwv
鲎	dzv
蠖	cbr
悃	ngs
祕	lna
係	may
唣	jnv
谮	icd
畀	blu
紛	ytp
裒	yyj
咥	jgi
磾	udu
訞	imt
镲	tll
锝	tbu
煩	xty
伕	mmf
郫	guf
蚬	cej
淯	otv
邡	yfe
奭	kuu
嗍	jsv
臜	vfq
讚	ift
蟲	ccc
頂	rty
螨	cbk
阈	eqm
赜	ene
組	ykq
怍	nra
爌	xxg
歲	jih
鳐	zab
鄣	suf
嚐	jdd
敵	kgl
陔	fph
歔	xnn
遊	yto
狁	pok
拶	hgx
擺	hcw
汆	kis
矽	uxx
觯	qvu
鹣	soz
呣	jnm
绹	yfb
託	iav
卍	www
卐	www
涬	oai
肏	krk
呒	jcu
袴	lke
钼	tfm
磲	uos
颡	rrt
勝	vmi
湜	odh
顧	zrt
皞	nnu
換	hqk
齮	jkx
彈	idu
搛	hsn
蝰	ckv
冇	ugk
眄	few
慊	nsn
劁	rxp
畋	blx
棗	nnb
肫	vej
貴	cft
夾	kkk
崦	eku
幷	akk
慘	noi
陳	fpe
瘋	ubc
冏	gtj
酹	zau
雮	rem
順	gty
塚	acz
簏	kal
胼	vsc
術	psz
髒	dbb
皝	nvl
脩	mlv
稱	waa
瘳	uni
锑	tsq
蝓	cgp
暌	dtm
壓	wda
舁	ybc
佔	mla
诜	ifk
芗	byx
尢	dyy
墬	foa
菔	bvr
瑨	ved
尙	hgj
選	ooo
蟻	ciq
瞾	ffe
犨	rrf
焓	xrj
琍	qwp
蒌	bdg
旆	ytc
愬	sjn
胙	vra
畢	bbh
癡	uwh
靸	zrj
癒	ugn
浈	ohq
觇	lej
缣	ysn
簡	ked
颞	frt
唦	joa
碡	uqn
補	ltf
擔	hqi
谠	idk
丟	vos
楙	scs
埽	aoz
聯	fyb
衝	pxm
栲	sae
牆	yad
統	ytk
倖	mai
鞬	zxo
鑛	txg
猲	pdp
俶	mir
踔	ehu
鲷	zgq
袼	log
芟	bts
僳	mud
產	cwn
磻	uib
槭	sih
討	iuc
呡	jbm
鲞	mzv
蚴	cyi
紙	yyv
邠	tpf
桴	sau
佧	mih
蒉	bcq
哢	jvb
檠	bss
囟	shi
飑	bho
燔	xib
費	int
騙	rzy
狨	pqu
觫	qps
疃	bkm
鲊	zra
伷	mgy
俵	mqy
賓	let
誴	ill
幞	znz
琇	vwv
溴	odp
栘	sxx
骔	rll
唑	jka
苊	bwc
騔	rdp
獚	pug
溷	ogr
囉	jcr
鲆	zks
掊	hkj
玡	vay
畚	okb
骖	roi
榇	sks
癜	unt
舉	yeh
鮮	ziy
塵	aat
堠	amv
泖	oym
浼	ozk
硗	uql
質	llt
隹	ruu
哿	ijx
睺	fmv
僦	mcd
帥	adz
釭	teg
硷	ugd
瑠	qyb
隈	fby
碚	ukj
劉	ytp
盤	ltc
馓	wul
沢	onz
側	mfp
奮	krb
隳	fuh
熦	xhr
罱	cui
戀	iyn
怃	ncu
嵫	esy
採	hic
偙	mkz
篼	knk
鐇	tib
揮	hcp
凊	fqv
僴	med
捽	hpu
彳	kcc
觌	uwe
揲	hus
辊	pdx
垕	wma
篥	kus
垴	apg
區	ajd
設	its
呑	mjk
醢	zuc
虮	cbj
诎	ijg
绱	ydj
昺	der
艹	bcc
蟗	fjc
埘	adu
陬	ffr
祓	lur
翚	ncp
锩	tmc
蠼	cfr
弒	hse
菘	bso
養	izm
圯	aos
羑	iqz
啫	jae
锕	tfx
赑	qqq
負	qft
糺	ywe
櫻	sfg
倧	mll
戥	dnq
蚶	cyg
佷	mmg
課	ibs
侔	mof
談	ixx
砼	uke
鳳	bez
藁	bcs
呙	jrn
鏡	tsk
靘	qvo
偉	mhw
絷	hmy
豬	rae
檛	sdo
镡	tuu
擋	hdb
崐	edx
牾	fvj
丅	ecs
硃	uap
釆	icc
籴	kdm
佴	mfe
瞢	bcf
杪	sha
遹	cgo
昃	dwk
弻	imi
搥	hao
堅	era
節	kmc
鬏	iwx
缧	yby
耪	tsy
訝	iay
揠	hag
淏	odm
畫	xbe
騎	rkx
橼	syr
雜	pkr
敗	ftl
爨	ygx
蓋	bac
伋	mrj
蛶	cau
狃	pwa
萩	bwx
須	ity
诼	irz
嗌	jsc
頓	ejt
驩	rbr
輪	pgy
嘌	jul
蛴	ccn
畎	bpq
詩	iws
楯	swf
議	iiq
雩	ree
鹆	czn
蕞	bdr
顫	pdt
盪	obc
殭	xee
皊	nrl
脬	vau
羼	nii
萊	bsk
缬	yqt
鍼	tim
漶	orn
叡	xtr
賞	djt
圖	gjd
奼	gav
哕	jex
荛	bql
適	kgo
谇	ipu
驗	rgk
廛	xma
廣	xug
埳	aqy
罵	crm
丏	ecw
狔	pnw
嚴	dwl
鑽	tft
氚	tgc
蒽	bgn
袷	lgh
懼	nfr
焌	xol
甍	bcm
黾	jud
烃	xre
铵	tlg
鬯	dgw
鵰	gqz
魽	zyg
铓	tbp
濃	oyz
襻	lch
嗾	jyv
躞	eir
緣	yor
柽	sra
镉	tug
遘	wgo
诖	ivg
绲	ydx
岵	exg
環	qcy
垍	adi
價	mut
據	hxr
涼	och
説	ivk
氽	kis
責	qft
錱	tvv
骯	dpb
钣	twr
逭	ldo
麍	atg
媺	gel
豨	rhz
蹤	ekh
徹	ktl
徳	kun
栱	sut
漢	ouk
觖	qak
莰	ban
崑	edx
茌	bma
疔	urd
茍	bsj
潔	oqy
圬	aee
禊	lqk
虿	epc
刳	kep
蝤	czq
預	cty
嗻	jxx
睜	fax
秕	wxb
蒼	brj
葑	bvu
呋	jmf
匦	apm
豇	aeg
堃	yya
慄	nus
嫽	gkh
铯	tqo
玹	vpy
圓	gjt
槍	srj
垧	asj
洧	ouv
顏	cwt
資	fnt
蠪	eec
吣	jnx
亻	mrr
婑	gwg
贇	cet
緾	ywm
劃	xbp
緩	yar
跡	eqi
桕	syj
钪	tpb
倐	mlx
浯	ovj
窬	rgp
紜	yty
埴	ani
惝	ndj
甙	qyg
崞	ecu
橫	sut
彊	iee
歐	ajn
眚	nfm
颃	pbt
觔	qil
蛞	cfs
憐	nda
臨	etd
昽	dzl
牤	fpw
貏	pgu
蚵	cxk
镆	tlm
嫋	gif
薷	brh
獄	pip
邧	tkf
瑧	vqw
茺	btk
蕻	bit
闶	epb
爛	xes
騄	roi
瑢	vlc
嫜	gsu
罷	cow
礡	ubu
郕	iwf
紞	yck
撫	hcu
囝	gui
蒗	qzm
嗙	jky
骍	rfx
厊	way
蚰	cgy
標	sul
鳔	zul
巉	ezz
骶	dyz
階	fxn
褲	lxp
圹	axg
焜	xdx
敉	dlx
呿	jao
徬	kky
幣	wlz
簦	kta
枹	sfo
鎗	trj
霑	rol
畛	bki
轵	pjt
黹	nwb
晡	dtf
燈	xta
湔	osp
瞀	clf
啍	jcu
鲀	zej
揚	hbi
貐	pgp
跦	eap
荘	bya
镚	tev
閉	eua
龀	awb
歸	adz
扌	hss
聞	efe
砉	qus
篪	kwb
觸	qcc
島	zes
鞔	zzk
仳	mxb
甡	nns
芄	bmz
猃	pgd
溆	okr
甾	gbt
钭	tld
髑	dcc
髙	ppj
啯	jgl
锘	tbu
髂	dlo
權	sbr
枱	soj
硪	uhq
潴	opa
湊	oqm
邨	ejf
垱	ado
宮	ljs
紀	yaj
裥	led
郐	ktf
瘘	udg
碖	ugy
肶	vxb
蘋	bjt
屺	eaj
弢	ijr
維	yru
猰	pqk
胗	vki
笪	kbd
鲼	zuq
翃	uon
劵	mil
衖	put
沬	opw
伾	mje
賽	lwt
枵	sje
紮	swy
專	tcu
髌	dlt
翙	exn
镙	tby
甯	lne
羟	ire
鲭	zqv
腧	vgp
龆	ama
沩	ozz
绁	yuw
崾	eug
蛏	cra
紡	yyf
邏	cyo
悫	fbn
溻	odn
湧	ooi
罾	cvd
晢	hld
舳	lgy
忉	npd
岡	gse
紘	yuo
勁	egi
稜	wal
樑	sos
笭	krl
蜱	cgu
氆	esd
氵	oss
餵	wby
曉	dal
遙	vbo
優	mtl
莊	bya
锸	txy
竐	kts
钒	tbz
褔	lmb
蹟	eqt
蛱	cms
敫	nyl
孒	tei
爝	xau
猸	pnf
鬆	iso
爺	thf
舯	lro
笾	kio
廢	xtt
罟	cxg
邽	vfe
铫	tkf
巖	edl
踬	ewq
箅	kbl
岀	ees
鬥	ldd
绋	yin
埝	arn
芘	bxb
濉	ofr
貼	ftl
籼	des
絜	qpy
楦	slb
曛	dxs
锳	tbk
聱	qpf
鹁	fuz
舡	leg
際	ftl
檞	sqf
顆	bst
硭	ubp
茆	bym
鬧	lpz
谂	irn
炱	ojx
钍	tat
俠	mkk
厭	wdp
沄	oty
馇	wsb
唪	jqh
烆	xpx
轟	ppp
纩	yxg
栝	sfs
蘭	bes
鎌	tsn
褰	lwy
搶	hrj
霧	rci
饩	wtq
楊	sbi
矅	fnr
駐	rzv
趑	dfn
菹	qkq
鳊	zzy
鲳	zdd
詭	iqc
滾	oyj
掎	hkx
屦	nkg
莨	bzm
撲	hnz
軟	pnq
昰	dbe
謂	ibv
緒	yae
円	hcj
玙	vee
棻	bts
膚	xbv
莩	bau
規	mfk
丨	css
喚	jqk
尨	uwi
埤	agu
濕	odx
羨	ion
揺	hag
螽	lfc
昪	dob
偑	mbc
齁	dbs
钅	tjj
醅	zkj
潽	osd
畑	xbt
靦	tfk
蜩	cgq
瘗	uma
莸	bpd
癍	uvv
埭	axi
導	sdu
啶	jlh
鞲	zwa
梿	spo
傉	mzu
憑	frn
棄	tus
枘	srn
庹	xuz
郄	huf
郤	cfe
硎	ucp
髹	ims
鈺	tlv
廌	aex
淨	oax
袓	lkq
蓮	bpo
熳	xqm
毪	eof
寧	lnr
庀	xwb
燄	qyx
暲	dsu
冑	gvy
淿	onz
氘	tnd
赙	qtu
洎	odi
湓	otc
悽	nxg
顒	brt
卣	lak
載	uqp
茈	bjw
浍	okt
栳	saw
煉	xps
辌	pch
忞	cnx
糵	bad
牽	pyf
紝	yvw
歎	umn
襲	eey
鮨	zwd
絺	yhz
豐	eqa
笱	ksj
旡	cuu
骒	rbs
阌	eir
姁	gsj
顔	kwt
擇	hci
搌	hny
摽	hul
纏	yxa
埵	axt
跽	ean
籐	kvi
廳	xfn
猶	pzq
災	gxh
揸	hsb
織	ysq
犇	fff
撐	hda
婦	goz
劼	qil
堺	abn
菉	boi
渫	ous
弇	gbc
證	ita
墜	fsa
僰	nnk
檒	cbc
槅	sug
蘫	boc
鬍	ixv
佉	mao
婼	gbu
邾	apf
膽	vqi
擐	hcy
噍	jrx
庫	xpc
氇	ezd
慮	xbn
汧	ock
蹻	emj
紗	yha
縮	ylu
觋	eke
堙	aua
撙	hzu
測	ofp
緋	ypf
複	ltl
挢	hmn
寬	lbz
鴷	xpz
謎	ido
颥	rht
赸	des
鲦	zls
燚	xxx
蘡	bfg
喲	jyz
蜎	cjv
悰	nll
刂	pdd
沲	otd
疳	uyg
凅	fgx
桄	sdl
揑	hye
喬	mjj
紋	ycw
誤	ijm
烝	wix
佇	mlr
瑊	qim
劇	xrp
嚭	pjj
碕	ukx
繞	yal
譔	iot
踣	ekj
髊	die
窭	rdg
凱	eab
瀰	oih
慓	nul
鞒	zmn
灑	oea
兟	fkk
慝	abn
烔	xgm
燰	xil
襞	njy
薑	bee
紟	yrw
臁	vxn
矧	vic
韋	hww
獯	pxs
瀹	ogy
執	aiz
蒇	biq
榱	syt
扽	hej
偳	meh
艴	ino
穀	few
僅	mzt
刭	rep
紤	ylj
唛	jql
眛	fpw
拏	grh
苤	bje
钋	thb
嗪	jqw
觍	yte
臥	ekr
蛘	ciy
遺	cfo
黪	soi
遞	wxo
岎	etp
暠	dcg
攉	hrr
雞	ayr
钕	tgn
毹	gve
損	hjt
廆	xgo
揾	hdc
勗	dki
氩	ten
玗	qeu
澐	ort
紥	hwy
闆	ejd
紣	ymu
垡	mqa
慣	nnt
璝	qct
缂	yzg
綨	yoq
玘	vaj
骀	roj
昖	dto
窅	rfm
菑	bgb
詧	tiy
锇	thq
鳇	znv
坰	agj
怾	njt
乇	avq
霨	rnu
肟	vee
瑎	qxn
飖	abh
嫄	gwh
禎	lht
鬷	uhl
財	fta
韂	zqi
雋	rcg
錄	toi
鷺	eoz
瘰	uby
哌	jwy
蜣	ciw
囂	dtd
仡	mtw
籀	khb
嘗	djd
蕩	boi
讀	iat
噁	jen
髠	ibj
鐮	txn
榮	xxs
辻	uod
痩	udr
薤	bxe
傭	mxe
憂	tnl
慾	cnn
牂	yiy
砟	ura
瓿	kjm
寀	lic
墮	fua
搿	hgh
僬	mrx
捲	hmc
瞞	fuk
蠛	cbz
孫	uay
誷	igp
鄉	yzf
曐	ddn
詠	izi
嵛	egp
惣	ffn
紦	yob
忭	nph
瘛	uqn
垌	agm
槔	snu
愰	ndl
礦	uxg
壸	fen
崙	egy
蛲	cql
鋪	ttf
锓	tor
滠	ofr
倓	mxx
煺	xmo
峣	eql
劓	dbp
頵	oat
暫	pld
唄	jft
凈	fax
咵	jke
鏐	tni
獴	pyr
嘧	jle
龐	xee
蟛	cpi
陴	fgu
俜	mge
袪	lao
洤	okv
騰	vmr
辋	pgp
鬚	iit
龠	gdy
腠	vqm
轹	pyh
稆	wjj
蝥	clc
蓂	ydf
堋	avv
擾	htl
汍	omz
猇	pxb
儀	miq
詟	ziy
鞴	zue
筆	kxv
詞	iwm
氾	ocj
咈	jin
齕	jkw
黉	dug
襕	les
柃	srl
镘	tqm
浽	oag
蝟	cbv
兇	hgk
燿	xnr
殪	xfa
蒡	bky
捯	hgp
旛	ytb
巿	ncs
胍	vag
骱	dkn
杩	srm
恧	hnx
跫	ebe
篍	kwx
唼	jkg
酾	zev
騦	rbn
穩	wan
垚	aaa
罃	xxb
餘	wkw
贠	oqb
躍	enr
掙	hax
職	fsq
娡	gan
輩	ppc
遲	nio
檔	sdb
硐	ugm
胲	vph
烀	xau
鄠	ref
碼	urm
跘	esh
噴	jut
凵	gkk
鰸	zad
氍	ffe
滲	ooi
輸	pgp
瓖	vyw
忮	nur
壯	yas
苾	bna
攧	hnt
芤	buw
岺	erl
罞	ccm
伱	mkh
瘮	uoi
灣	oii
痖	uen
嘢	jmc
踰	egp
箢	klc
哳	jhl
鲡	zev
枬	sgp
檎	skr
紹	yma
橦	skm
嘯	jxy
諲	iua
饔	pyw
枊	syc
戽	zld
狤	pqj
峧	efh
囧	gtg
蚑	cur
齊	pst
蠍	cdn
砑	uay
嚥	jux
顗	eat
營	xxj
纻	yle
甏	pim
廁	xfp
漎	okh
盜	onc
氡	tlf
钬	txh
唻	jsk
墚	aos
鳴	jzn
寢	lyr
苘	bgj
饣	wss
瑱	vnt
穸	rxx
翛	mln
洨	ofh
晹	ddi
針	tus
丒	pze
尷	dec
觏	wge
骺	dwm
媩	gxv
嚄	jbr
枧	sej
俫	mps
瑯	qzf
髎	dni
凜	fpw
鹨	nkz
毎	tng
麵	skt
瘼	ulm
桤	sea
軀	gad
毵	oke
獸	dbp
谞	ihv
糈	dhv
镟	tyh
頉	jty
諸	iae
酲	zjv
楱	sqm
帯	bez
峎	emg
岣	esj
嶲	erg
喨	jcb
苶	bkh
肷	vnq
傾	mwt
睱	fnr
铦	tfs
曌	dve
憤	nut
柺	sji
扞	hkg
積	wqt
麿	xcj
挻	hao
蕬	byy
辒	pdc
懲	kvn
餓	whq
铒	tfe
戶	zhh
鲣	zpa
鑑	tec
蛑	cof
笢	kbm
農	yzc
啟	zjl
葇	bcs
裼	ldi
塼	atu
熺	xpj
黡	wps
煐	xbk
湲	oar
帳	zei
酎	zuc
毳	eee
坫	ala
額	lot
酐	zkg
鈴	trl
痲	uuw
潵	oul
埜	cat
匚	akk
蕡	but
夬	akr
铪	tgh
滉	odl
獎	yvp
贶	qjk
靣	ead
紕	yxb
伹	mkq
胂	vds
钘	tck
閻	eqy
贏	pjt
躜	efq
摛	hpr
鎚	tao
袝	lmu
構	swa
嵴	efv
趼	eck
锊	tau
泺	oyh
悶	enx
勔	til
諾	ibu
擗	hnf
玱	vkc
犭	pqq
渖	old
肅	xyy
舺	lgj
烋	msx
訚	eiy
妘	gty
舴	lra
孖	uui
繃	yev
疬	uwi
肭	vrn
簽	kgk
橋	smj
掃	hoz
螣	vmc
涠	ogh
鹇	esz
獻	xup
慉	npb
璿	qxf
碹	ulb
晊	dgi
粢	fnd
眵	fxx
咁	jyg
蟪	ctn
劂	wsp
嘅	jmc
苈	bwi
脈	vwy
翹	aan
銳	ttk
锼	tyr
躧	eea
篂	kdn
珧	vkf
靿	zyi
吲	jic
撥	htt
脞	vka
嶝	eta
锾	tar
籃	kec
饹	wog
簾	kxn
钌	ttl
緜	nzy
坭	anw
嬸	glb
骕	rxt
項	ety
縡	ylf
斬	plj
賺	ftn
編	yzy
镈	ttu
碲	ukz
瓞	aam
賭	fta
鄜	afe
茳	qeg
儘	mxc
諒	ich
躐	egy
嵝	edg
陧	fml
厍	wpc
鹴	rsz
鎖	tdt
畤	bws
鄹	frf
砹	ubh
綁	yqf
跐	ejw
砘	uej
燉	xcl
鸸	hzn
館	wld
輝	dlp
熲	wxt
牻	fui
踡	emc
甦	pns
螗	cxj
铽	tqn
訓	igc
製	fzy
縱	ykh
阼	fra
埯	aku
沷	our
姤	gwm
貨	mwt
廑	xzt
碦	ulo
嫏	gzf
歛	gdn
堳	anf
迺	uod
捨	hkf
摅	hxn
潄	opl
塽	akh
芴	bfi
飲	wnq
澤	oci
盩	aic
丶	zdd
茲	byy
襬	lcw
苄	bph
叢	nir
憞	ncl
扢	htw
琯	vld
賤	ftq
嬌	gmj
舊	bry
醵	zxr
掯	hjv
燘	xec
硇	ush
惱	ngh
鬿	gol
誦	ioe
鞗	mcz
酴	zkw
堍	azz
彎	iyi
舾	lux
舄	yfx
暈	dcp
姪	ggi
崒	epu
艚	lyd
榖	fes
腘	vgl
晧	dfj
缋	ycq
夼	kgc
虧	xre
懶	npt
爐	xxc
駛	rjh
湯	obi
鼗	kfr
筅	kfk
兗	ptk
浥	ojo
奓	kxx
紖	yic
皺	fjz
筯	kki
剉	kkp
胨	vvh
砜	ubh
饸	wgh
擠	hpt
鲚	zcn
鍵	txo
矻	utw
俛	mzk
淠	obl
拤	hih
圊	gqv
儍	mdl
蔘	boi
鮻	zol
違	hod
烏	znn
迕	tuo
祄	lkn
衪	ldy
臟	vbe
拃	hra
钸	tuz
倉	rzj
菪	blu
兊	tok
杮	snc
禍	ldj
哜	jcn
勞	xxi
輛	pek
貎	pyk
撚	hvx
棲	sxg
蒨	bmv
朊	vtk
喪	ady
阘	edn
兲	vtb
甕	pym
釿	tlj
鹓	lxz
鐾	njt
滗	oke
扠	hrz
躔	exa
奌	lkd
凍	fpe
罣	cvg
丷	sbb
喛	jar
腈	vqv
筘	khj
蠊	cxn
暸	dkh
盧	xbc
彌	ith
豾	pje
埼	akx
骎	ror
惓	nmc
飾	wtz
谿	ayc
箦	kne
橥	pas
斲	wwl
奧	sik
鞞	zgu
辶	odd
溝	owa
毌	ngg
馘	sdm
癋	uen
縠	fey
蕺	bjq
濟	opt
駕	ijr
琎	vwo
絶	yqo
镧	tes
浬	oml
琝	qdc
犏	fzy
圏	gma
亊	esx
獞	pkm
漥	orv
暐	dhw
爚	xgy
仉	mbj
詛	ikq
髟	icc
瘥	uie
籓	kob
鋒	tlq
绠	ypg
糇	dmv
獲	pbr
頸	egt
徑	kee
垲	aea
綑	ygs
獵	pgy
坶	anm
齉	dby
旂	ytl
巻	maj
骦	rrf
罈	buu
觽	qeg
莶	bgd
瀟	oby
姎	ggk
扆	zyi
贊	fkt
飐	bhl
坌	tpa
暢	dbi
蹯	eib
钫	tyf
廻	doy
監	ekc
礓	uee
滘	ocj
梱	sgs
侶	mjs
暼	wld
潛	ocd
佢	maa
挼	hag
褟	ldn
臺	qcg
踼	ebi
頹	wkt
洩	oda
忄	nxx
欻	xxn
堉	atv
玧	qok
揞	hsy
昻	dec
铋	tna
閟	ena
辭	aof
岽	evh
厾	wao
奪	kru
縫	ylo
閤	egh
轘	pcy
臘	vgy
両	nes
蹽	ekh
罠	cbm
肀	xvv
裵	ypf
鸲	szn
嫰	gpn
潤	oev
璛	qxy
羰	iex
缷	bcj
趐	dnv
悅	ntk
垞	alv
恥	fnx
傺	mtl
飺	jww
淓	oby
昐	dtp
澉	owl
槨	scf
繫	pgy
肼	vwj
匊	fdm
潰	oct
胬	grk
衄	aca
锫	tkj
禥	loa
倿	mkg
剠	chp
塙	acg
陞	faa
酞	zkz
濤	oau
梶	sne
鼯	yvj
啣	jbc
廂	xsf
蚃	ycc
桖	sac
勳	xsi
簷	kqi
垟	aiy
廙	xbt
藝	bat
齋	psl
厔	wgi
縳	ytu
枨	sic
珵	vjv
闖	erm
聰	fsn
咶	jfs
楶	fns
赆	qnf
躹	gfd
櫆	sgl
圝	giy
螞	crm
鹛	nfz
鹋	bbz
窮	rgi
葰	bml
炧	xtd
榍	snv
鹯	pdz
誌	ian
鑄	tau
窀	rej
棁	svk
鲃	zob
窆	rab
轒	put
葢	bkc
騩	rgo
粿	dbs
桊	msm
捃	hoj
欗	sbs
鎯	tzf
礌	urb
燜	xen
砮	gru
璆	vni
晩	dqk
蕹	bpr
葙	bsf
讠	iyy
罨	cku
鷹	xmz
瓚	qft
鍾	txm
锿	tyj
轪	pkd
罰	cip
酤	zxg
蜾	cbs
餜	wbs
恝	qpn
樫	sea
劒	gdz
蟭	crx
蟜	cmj
誡	iqb
蒟	bks
鎧	tea
銙	tke
賴	pqt
欄	ses
跞	eyh
療	ukh
蟟	ckh
倫	mgy
棆	sgy
濆	out
恓	nux
睒	fxx
蒴	bsv
俬	mwo
锬	txx
篠	kms
媭	itg
訊	iwu
渰	ogb
鲻	zgb
牴	fyz
绗	ypx
訸	iwh
熇	xcg
锪	tfn
罽	cwp
謹	izt
闊	eof
蠻	iyc
懞	nyr
厐	wzl
钷	taj
皘	nqv
巯	reg
璱	vva
祏	lus
鷫	xyz
閑	esm
懸	khn
眢	xcf
丬	ypp
歩	jha
憝	cun
饳	wjg
糼	yil
貫	nft
冱	feo
韁	zee
覚	dfk
鹍	dxz
勵	wbi
浰	owp
廟	xuv
糢	dlm
傘	kku
蛸	cdv
獅	paz
掭	hmh
鉵	tcc
偓	mng
懗	nan
虓	mxb
噀	jot
缊	ydc
驵	rkq
阯	fji
滍	ojc
稙	wni
礙	uwh
庳	xgu
萆	bgu
蔵	bie
讇	iey
倅	mpu
瘅	uvu
铞	tjz
芣	bjb
馉	wdg
鳸	zzn
衁	pac
飢	wbj
撿	hgk
眍	fah
瀬	opt
糧	dbm
崚	eal
鄤	qfe
掹	huc
齧	qpg
杻	swa
実	lqf
聳	kkf
羧	iol
钽	tbd
詳	iiy
瑆	vdn
蔭	bft
柊	slf
註	izv
瘭	uul
嶒	evd
刬	eqp
瑒	qbi
帱	zqu
醜	zgo
搋	hwb
腄	vxt
阽	fla
歺	xdd
渄	opf
墳	aut
阝	fee
嘠	jtq
鹱	zbr
渾	ocp
鲒	zqj
挶	hnj
罝	ckq
姖	gaa
纍	bby
芼	bem
綿	ynz
眽	fwy
蕅	bor
甓	njm
棨	zls
縴	ypf
锖	tqv
繻	yrh
汭	orn
爇	bax
憟	nud
貪	rwt
璮	vpb
祹	lfb
趯	dnr
捥	hlc
噏	jgn
蓥	ytj
緻	ygl
浐	okw
蚇	cnz
賜	fti
扥	hav
癲	unt
垤	agi
兌	tjk
峯	elq
洑	omp
祔	lmu
悺	nld
櫃	sat
矦	qwv
寯	lrg
衎	pkg
峇	egh
尅	xku
泐	ofi
劙	orp
嚕	jzd
魯	zdr
荬	bwk
眊	fem
蝻	cui
膩	vqt
勸	bdi
鎙	tsv
箨	khh
汙	oeu
脅	iiv
晅	deb
蠅	cee
瘵	utl
揹	hyv
逬	ako
痺	ugu
廍	xkf
偲	mbn
冊	ycc
瞝	fpr
垯	ako
禘	lkz
訶	ixk
鹖	dfz
靬	zkg
谫	isp
檢	sgk
倞	mch
胩	vih
窺	rmk
罍	bbb
钔	tem
嬝	gzy
朅	aop
騷	rrc
騊	rfb
蓰	bkh
妶	gpy
挾	hkk
訏	ieu
曵	dwz
絪	ygk
嬰	ftg
運	cpo
臢	vft
迮	rod
晣	dhl
鎮	tnt
苧	blr
雸	ryg
犮	ury
飽	wfo
誧	itf
耖	tsa
鶉	cuz
溚	obg
鵝	hqz
羮	ixk
峠	eih
潅	otr
賀	ijt
穫	wbr
唊	jkk
踺	exo
濺	ofq
凥	nbj
跼	enj
齡	jkr
瑪	qrm
嚜	jsa
暪	duk
椠	pls
碃	uqv
驅	rad
諡	itc
纟	yss
嗢	jdc
鳼	czn
窩	rdj
嗚	jzn
卨	hdj
衒	ppy
簃	kwx
瑩	xxl
炤	xma
夂	lxx
廒	xql
襜	lqi
脣	zvy
竄	rys
亸	cuu
訪	iyf
刧	aop
褧	fxy
廇	xyb
嘍	jjg
璷	qtl
葎	bkx
宀	lll
譜	isd
殼	feb
豎	era
脽	vru
絃	ypy
洐	opx
詢	ifd
嫕	gan
挓	hlv
朘	vol
錶	tqy
併	msc
侘	mlv
赪	anq
齒	jkg
吜	jwa
儲	mia
啲	jnz
睪	cai
餬	wxv
耞	tsj
蓳	bzt
閰	eyj
氪	txk
霊	ren
鬘	iqm
娒	gtn
聍	flr
榀	sjd
攵	lxx
渏	okx
鰭	zad
鹙	wxz
赇	qiq
屻	epz
涁	osi
繩	yee
攤	hur
惔	nxx
藫	bou
醣	zxj
駼	rkw
亹	pyk
氙	tes
鴞	jez
軒	pkg
泶	dis
珜	qiy
癢	uim
衤	lss
褕	lgp
誅	iap
築	kes
辯	fif
彆	wli
猹	psb
踆	eol
撘	hkg
蛁	cma
褍	leh
篚	kap
牿	ffj
龜	eei
斝	dcl
減	oim
溍	oed
磡	uoi
擓	har
寛	lbk
骙	rtm
癩	upt
籙	kti
嚒	jxy
暱	dau
噽	pje
丿	app
慶	awl
渋	ojf
埏	aao
螦	cqy
燙	obx
遆	kzo
盷	fff
袥	lus
窊	rag
珦	vsj
鯹	zdn
頁	tyy
裀	lgk
閱	etk
皽	pdz
貞	hft
証	ibe
玚	vwi
馳	rdy
焠	xpu
楓	sbc
镓	tlr
憍	nmj
燋	xrx
珓	qfh
糾	ycj
锎	tec
哴	jzm
鱗	zda
摟	hjg
茻	jjj
納	yrn
評	iks
頗	zty
蹡	eyu
攝	hff
褆	ldh
爍	xns
癎	ued
舣	lzh
鬱	sbi
卆	mus
皕	uub
礤	ubl
蹅	esb
鼌	bju
崈	lle
黨	djs
妸	gxk
峊	ade
賦	ftj
縛	ytu
蹐	efv
筊	kfh
荊	bcp
倶	mft
巈	ezd
悾	nre
裈	lcp
鑨	tee
祿	loi
仫	mao
溼	oea
蝕	wcc
栻	sqe
樋	soo
鼷	yak
蓆	bxz
覤	xbk
謔	ixo
枒	say
偊	mar
痄	ura
顓	eht
揝	hld
抃	hph
咇	jna
螬	cyd
趎	dap
疍	hbd
巔	ent
訂	ird
敚	vkl
朏	vjg
菓	bbs
馃	wbs
鞃	zio
怳	njk
姞	gqj
漈	otl
競	kjk
鏮	txi
榼	sac
鳢	zya
唡	jek
礟	urh
毘	bxb
顠	ult
攴	xdd
矝	crl
濪	oqo
饒	wal
掻	hrc
頑	tkt
頠	qwt
搵	hgc
焮	xln
燻	xxs
纁	yxs
艷	eqo
杙	sqi
鳙	zxe
愑	noi
颭	bal
偡	mow
扙	heh
週	gqo
砫	uzv
鐲	tcc
繤	bfy
菴	bku
爊	xax
艸	jjc
瀍	oxa
償	mdt
鈔	tha
櫈	stb
蝀	cpe
镦	tcl
羵	iut
諷	ibc
匄	fpw
洸	odl
蓕	bsv
鍋	tdj
撖	hwl
镮	tcy
頰	kkt
耩	tsa
洚	ola
拠	hlb
畯	bol
犺	ppb
嵙	ewl
硁	ure
铑	taw
瞵	fda
菻	bcl
鬽	goi
蒳	byr
闢	enf
鸊	njz
螵	cul
頻	jht
葜	bqk
麹	qld
膄	vyr
帨	zvk
稅	wtk
壇	apb
撢	huu
鷉	wxz
磌	unt
聼	wfn
塗	oka
尪	dvw
濊	ojh
斅	yhx
噓	jxn
藚	bat
愝	nag
儼	mdl
钇	twi
億	msn
麀	awb
懮	ntl
嶽	epp
綻	ylh
眞	wft
迍	ejo
蔔	bfb
雛	fjr
娖	geu
誕	iao
唗	jdo
荳	bad
鞥	zgb
汎	obz
鈇	tmf
鋼	tge
購	fta
闔	eac
鉷	tut
魟	zeg
匯	aor
璾	qpt
楗	sxo
圧	wat
誇	ike
鏈	tpo
瞜	fjg
呂	jsk
镎	tgh
挷	hqf
捊	hau
奷	gxq
籤	kke
囷	gwh
澀	opj
曬	dea
钐	tis
熌	xek
贳	uwq
竢	kov
飼	wwm
筭	kvb
媧	gdj
杇	see
狹	pkk
鸺	msz
歘	xxn
廴	oyy
澭	opr
矞	cgj
璪	vjs
嘖	jqt
偵	mht
媜	ght
蹱	ekm
芧	bcv
凖	fru
盦	rwc
貝	ftb
醭	znz
腸	vbi
漼	oer
鱽	zpd
疊	bbk
誐	ihq
阨	fwc
輔	ptf
吿	fjk
閣	eog
袞	ytj
濄	odo
囍	pjj
嚿	jby
禝	lbl
蔣	byu
驕	rmj
轎	pmj
侷	mnj
芵	bak
蟸	rcc
砢	uxk
曪	dcr
絡	yog
邁	bbo
禖	lys
曚	dyr
挐	gjh
萳	bui
擬	hwh
囓	jqg
潑	ott
謙	isn
竊	rir
胠	vao
審	lib
筍	kfd
橝	suu
醰	zuu
镋	tdk
朣	vkm
涴	olc
晼	dlc
偽	mzx
翾	cmn
壄	sca
瘖	usy
灜	opt
郵	xbf
畬	kwb
骣	rnu
辀	plo
甃	wxm
僎	mot
絔	yub
鹎	guz
揙	hzy
昞	der
裯	lgq
搗	hze
嶋	ezn
顛	ntt
哋	jad
棟	spe
耑	ehe
擱	heo
槻	smk
軌	pmj
囯	gvw
嚆	jbc
彙	ocs
耠	tsg
劐	brp
濩	obr
癨	urr
敧	kxx
泂	ogj
摎	hni
犋	fkt
麕	agw
狜	pxg
窾	ran
矌	fxg
镴	tgy
鳓	zzi
蔹	bgl
泙	oks
舖	kft
宆	lig
瀼	oyw
込	kod
篛	kif
蘇	bzw
鹔	xnz
擡	hqg
菼	bxx
搯	hay
筳	kvo
眮	fgm
腽	vdc
碨	uby
儛	mta
栒	sfd
掞	hxx
鴦	gkz
倻	mff
蛦	cki
泆	oam
鹢	stz
鄘	xxf
雝	gjr
賊	ftu
戦	dbq
滯	obz
膣	vrg
镃	tsy
攽	tpl
邉	dro
憯	ncd
滄	orj
艙	lrj
勅	pil
噇	jkm
蔥	bsn
尓	thx
澴	ocy
喤	jnv
績	yqt
脥	vkk
経	yra
朧	vee
靇	ree
駡	drm
朒	vrk
鞶	ltz
髈	dky
浿	oft
抷	hje
闋	etm
眘	ksf
瞍	fyr
穌	zwh
餗	wps
譚	iuu
饀	way
萜	bzl
誔	ivo
銅	tgm
賢	ert
銷	tdv
噷	jsn
婞	gai
洶	ofg
鸴	dzn
鐚	ten
巘	exp
鑰	tgy
鄴	nif
吚	joa
隠	fan
怮	nyi
譽	yei
軏	plu
抜	hur
舭	lxb
斃	wlw
飊	xxc
馎	wtu
偁	maa
踧	eir
躭	gck
淂	obu
撴	hcl
遯	vro
钆	twe
葔	bmv
謊	ibg
漷	ocf
瘕	unr
橿	see
訣	iak
釦	tjk
曠	dxg
裩	ldx
稂	wzm
睖	fal
麥	skl
厖	wui
羃	clz
煵	xui
摰	ath
侫	mpg
柈	ssh
鈚	txb
噐	ded
杄	sxq
嗛	jsn
覷	xnk
刄	pzd
蒻	bif
脎	vhs
鰣	zdw
丗	bei
蒐	bgo
灘	our
餂	wfs
朓	vkf
魋	gor
饦	wav
窪	rov
渦	odj
盻	fte
陜	fkk
纖	yke
鹹	ldm
啞	jen
靨	wdt
宧	lec
轅	pay
慍	ngc
債	mqt
漲	oie
鄭	zkf
鐏	tzu
薆	bil
奡	tkn
沘	oxb
嗶	jbh
侼	mfu
噠	jao
耵	frd
靪	zrd
胐	vjg
糞	dbt
綱	yge
雚	bdr
鬹	mfu
駭	rph
艱	umm
瀞	oqx
懇	pmn
楛	sbx
膦	vda
矓	fee
僇	mni
巒	iye
镅	tnf
祙	lpw
皏	nsc
豈	ead
棬	smc
隢	fal
壽	awu
樉	skh
舑	fga
癱	uur
縢	vmy
渟	ocr
禿	wke
稌	wkw
剬	ehp
滃	otn
娭	gov
粞	dux
潝	ogn
効	fhi
屭	nft
廞	xtn
嬿	gux
咉	jgk
殽	hut
螢	xxc
暎	dbk
緼	ydc
韻	sjt
膪	vkj
徴	kev
晸	dbl
扺	hyv
驟	rfi
玆	pyy
掫	hfr
憊	mun
珌	vna
疪	uxb
缏	ymp
蠙	clt
砵	use
蔀	bkf
燦	xxd
鸧	kcz
襯	lkk
遫	plo
寵	lee
慒	nyd
篴	kro
鮗	zlf
篤	krm
囮	gmw
筦	klk
暤	dnu
頀	sbr
擭	hbr
虀	bpe
巜	gcc
擴	hxg
攔	hes
咾	jaw
癃	ufn
嚨	jee
躘	eee
嬤	gxy
獰	plr
鈕	twa
柸	sje
軿	psc
酺	ztf
贌	ftz
嗆	jrj
碻	ucg
虇	bir
宭	loj
騒	rrc
袑	lma
侁	mfk
摗	hpn
逷	dfo
坉	aej
鮀	zlw
吳	jwk
縣	khy
呴	jsj
醑	zhv
昫	dsj
醃	zku
魘	wdo
祅	lmt
洢	oma
铟	tgk
迶	uvo
漁	ozv
黦	slc
煴	xdc
栆	mcf
邅	pdo
铚	tgi
柷	sjk
疰	uzv
瑑	vor
葊	bgb
磝	uql
豝	rob
剝	oip
狽	pft
鏰	tev
皀	nwb
変	qlx
辮	fyf
鏢	tul
餅	wsc
棌	sic
剷	kwp
敊	ihx
倕	mxt
鬴	utf
筸	kdk
僱	mzr
鞎	zmg
恗	nke
嘩	jbh
檓	syt
鑯	tke
暕	dps
屆	nag
搢	hed
韮	bpe
踘	efd
蠟	cgy
漤	ocg
蜋	czm
耢	tsi
瓃	qbb
藟	bbb
褵	lpr
槤	spo
鰡	zyb
竜	kud
瓏	qee
嚧	jxc
鹵	ldm
昩	dpm
毣	nem
倷	mkl
湳	oui
铌	tnw
釀	zyw
瓫	tpm
喯	jkb
憵	njn
啓	zlj
兛	xkx
硚	umn
靑	qhc
臞	vfr
絨	yqu
鎔	tlc
鬺	uti
儵	mls
璹	qau
繐	ytn
咷	jkf
屜	nkw
涶	oxt
嫵	gcu
唌	jao
挦	hou
嘨	jxd
遜	uao
瑤	qvb
耰	tsl
扜	heu
寃	lzz
杬	stk
抯	hkq
趙	ddv
鬒	int
鈡	tro
鰲	qpz
栢	sub
鰏	zmb
觱	imq
碥	uzy
駁	rhh
愖	now
挰	hjv
錞	tcu
玼	vjw
镩	trr
礑	udb
觝	qyz
绖	ygi
緞	yht
箙	kvr
簠	ktc
乢	ewe
搆	hwa
頷	rwt
狢	pog
鰉	znv
宊	lpq
藠	bnn
岕	ekn
燼	xxc
莖	bee
豤	rmg
鲙	zkt
儈	mgd
欵	wvn
籟	kpt
蘿	bcr
犖	xxf
蔴	bxc
莾	bkb
眫	fsh
矈	fny
麑	ayk
襛	lyz
汸	oyf
賠	ftj
慽	nih
臍	vpt
蹺	eal
睄	fdv
坵	ale
擩	hrh
揌	hbn
羶	ipb
脤	vzc
涭	oir
簑	kyt
渧	okz
殢	xbz
鉄	tam
筩	koe
妧	gtk
葦	bhw
呉	jwt
旿	dtu
晛	dfk
揳	hqk
鬵	ccu
茓	brx
焄	oax
鴳	lgz
験	rgk
謠	ivb
滛	oab
霙	rbk
嵎	ebr
睮	fgp
髃	dbr
蓣	bct
籥	kgy
勻	fte
簮	kmd
曽	vdr
劄	kgp
栴	stp
衆	aci
鴸	apz
畷	brr
菝	bhr
蝂	cyr
鞆	zer
嵖	esb
怊	nma
熾	xsq
錘	txt
蝽	cqd
惙	nrr
賨	llt
咑	jhr
獃	eap
泹	obd
旳	dfz
弔	ics
釘	trd
吪	jmw
棐	psm
屝	npf
镄	tiq
唝	jeq
鉤	tsj
苽	bag
枴	sjp
豗	lrs
踖	eud
榢	slr
捁	hfj
鈌	tak
莙	boj
誙	iee
骻	dke
饋	wct
铼	tps
悢	nzm
仂	mil
扐	hil
豊	yad
斂	gdl
鄰	dxf
稟	pdw
舲	lrl
嶺	ert
籠	kee
縷	yjg
鸁	pjz
鄚	lfe
黴	ksh
渼	oik
蜺	cyk
鞰	zdc
磞	uev
憇	fyn
愜	nak
庼	xwt
麯	sky
嗮	jdu
笹	kuw
氺	iss
碩	uty
耥	tsj
儯	mmr
凃	fkw
嗗	jdg
瑋	qhw
崄	egd
澥	oqf
敘	kwl
喓	jug
譯	ici
濙	oxx
癕	upr
纋	ytl
礜	yeu
皁	nus
譟	ijs
肈	zqx
袗	lki
猙	pax
巵	weo
濁	occ
頒	tpt
诐	izp
徧	kzy
飆	ppc
掤	hvv
鲌	znb
蠶	ccc
拺	hnb
劖	zxp
産	kwn
箠	kxt
輟	prr
瑳	vie
憚	ndu
頔	gty
挕	hfe
苳	blf
嬻	gat
蠧	fuc
崿	ede
尃	tuc
鞷	uzg
堌	agx
唅	jrj
澒	oet
鰗	zxv
瓛	qxp
癀	uug
姦	ggg
洊	ouu
晈	dfh
牁	yxk
硿	ure
焅	xfj
嵐	ebc
鵹	wfz
灕	opr
飗	bhb
侓	mxv
盝	oic
鑾	iyt
淪	ogy
儸	mcr
暋	bld
脲	vni
搫	lth
貧	tpt
郱	scf
拑	hyg
缲	yjs
寑	lmr
匤	alv
栣	smv
牣	fpz
袵	lmv
訕	ies
渻	ohf
飔	bhn
頌	tot
鲐	zoj
慆	nay
鰧	vmz
詑	ilw
紈	ymz
蟁	bcc
犧	fiq
蚿	cpy
缐	yni
铏	tcp
喣	jsx
鴉	azn
酏	zdy
癮	ufn
楢	szq
滪	oct
淵	oyy
蘊	byc
攢	hft
贈	ftd
霅	riy
窋	rjg
磚	utu
踨	ekh
铇	tfo
盃	jcm
偪	mmb
熛	xul
嚗	jdi
吥	jjb
綵	yic
禪	ldu
宬	liw
礎	uch
墊	aia
壂	nua
釣	tfz
妬	gus
陏	fuv
柮	sjg
枙	swc
墦	aib
鼢	ytp
戤	vrq
榦	uds
槓	set
肐	vtw
鈎	tfo
袿	lvg
巂	erj
韓	udh
翯	ncg
戸	zhh
懽	nbr
讙	ibr
穢	wjh
惛	nyd
羈	czr
済	oct
牋	yqq
漿	yvi
澆	oal
皦	nnl
褯	lxz
冂	gkk
痀	usj
邭	sfe
脧	vol
譎	icj
痾	ufx
濫	oec
睸	fnf
鳘	tnz
婗	gyk
輗	pyk
楩	smp
樸	snz
竅	rnl
勍	chi
恘	nms
嬬	grh
鱓	zdu
煶	xdh
凘	fol
亖	tte
娀	gqu
鎲	tdk
摥	hti
醄	zfb
鳀	zdh
涏	ovo
赨	anc
蜼	cru
齆	dbo
臒	vbr
煕	acx
稧	wqk
陿	fak
睍	ffk
媟	gus
釁	ygp
挜	hen
棪	sxx
彥	cwi
傜	mab
嶬	eiq
禋	lua
慇	won
嚚	ded
廕	xft
憗	skn
逌	lao
兪	keg
秗	wmt
鸑	piz
慥	nfo
簉	kfo
矰	vvd
氈	pde
脹	vei
蹠	exx
穉	wnf
蠋	ccc
粧	dxa
樁	sqy
綴	yrr
啅	jhu
滶	oql
茇	bur
袐	lna
嗏	jbs
悵	nei
疢	uxh
橕	sda
綢	ygq
麄	tpa
缞	yyt
炟	xbd
璫	qdb
窎	rzn
脰	vad
闍	eae
覩	afk
鍛	tht
軃	gdu
毦	fem
発	ttk
轓	pib
雰	rtp
漧	ouw
挌	hog
玽	qsj
煹	xwa
迒	pbo
壺	fcc
沍	oeo
絙	yeb
鐄	tug
膠	vni
誱	ixh
兓	ccu
慬	nzt
鐻	txr
罥	cjv
欬	pnq
冦	ctx
恇	nav
磈	ugo
荖	baw
犂	wff
醨	zpr
憀	nni
燐	xda
醁	zoi
録	toi
礞	uyr
緲	yfa
銘	txj
驀	lrm
獏	plm
侽	mbi
臲	dsc
幋	ltz
姵	gbz
骹	dfh
唚	jor
趨	dfj
碏	uud
髥	igt
勷	ydi
磉	urs
飋	baa
硰	ohu
滳	okj
瞫	fuu
膆	vqy
祘	lls
粋	dmu
穂	wun
稊	wsq
屇	nbt
塆	aqi
碔	uej
巇	exq
虩	ddb
煆	xnr
蝦	cnr
梟	zsm
綉	ywv
魖	gon
碞	jdu
曮	ddl
贗	wmt
繄	avy
酂	fkf
増	avd
磳	uvd
詐	ira
酙	zld
嫃	gnt
锧	twq
腫	vxm
囑	jnc
眝	flr
絆	ysh
褾	lul
徶	kwl
嶓	eib
愽	ntu
厠	wfp
筴	kkk
秅	wav
釵	trz
攙	hzz
鋋	tao
儭	mkk
歯	jdg
珫	vtk
鉏	tkq
篨	kfw
閦	ekk
齪	jke
佽	mfn
欉	snr
訑	idy
噉	jwl
菿	bgp
琱	qgq
鯛	zgq
魀	gon
崗	ege
廾	bcc
闬	ekg
淊	oqy
秏	wem
滈	ocg
郈	wmf
睆	flk
鷬	ugz
緝	yjf
牮	mqf
膙	vic
醬	yvz
絞	yfh
攪	hyk
澽	oxr
嵁	eow
姱	gke
蔾	bws
瑮	qus
曆	wwd
漻	oni
繚	ykh
狑	prl
癴	uih
覼	tzk
駹	rui
毷	dfe
緬	ytm
繆	yni
擵	hxh
薿	bwh
哖	jta
糥	dhh
嘔	jad
呠	jse
鵬	vvz
哱	jfu
堷	asy
僕	mnz
镨	tsd
帢	zgh
趫	dmj
帩	zdv
鞧	zzq
蘘	byw
壖	arh
刪	ypd
蒒	baz
贖	ftt
欶	pnq
騃	rov
颼	bar
熣	xer
瑣	qdt
飸	jew
哃	jgm
衕	pgm
鵚	wbz
兎	eei
椀	slc
烓	xvg
喴	jig
齷	jkg
菥	bsl
焟	xud
憙	pjn
绤	ycg
誸	iiy
焇	xdv
蕭	bxy
詨	ifh
諧	ixn
緤	yus
睲	fdn
蟳	cou
様	sii
訳	inz
骃	rgk
溁	oys
縈	xxy
嫞	gxe
齬	jkj
猨	par
蹧	eyd
唶	jud
盞	qqc
蹍	eny
轍	ptl
淛	ofp
姫	gec
覙	qhk
袠	yam
擿	hko
錐	tru
耔	tsu
葅	bkk
譪	ibp
拝	heq
粄	dwr
鯾	zmp
繽	ylt
桲	sfu
筞	kls
镵	tzz
琩	qdd
煼	xfj
牚	dja
鐺	tdb
乗	wun
貙	pad
廚	xpu
処	lbj
諔	iir
涰	orr
歠	rrn
攅	hmt
禂	lgq
踶	edh
涷	ope
迵	gmo
鈍	tej
姶	ggh
羒	itp
髴	iin
冓	wga
瘝	uci
錧	tld
矔	fbr
瓌	qyi
兯	scj
釬	tkg
吰	juo
阛	ecy
鹮	cmz
锽	tnv
鍠	tnv
湝	oxn
寖	lor
婙	gqx
杦	sqz
抅	hfo
潏	ocj
勀	xki
軦	pjk
楏	skv
蝲	cpp
鞡	zhk
嘮	jxi
矋	fwr
籬	kpr
苙	bkl
璉	qpo
爧	xrk
飂	bai
髏	djg
廬	xxc
圞	gis
踚	egy
蓏	baa
酕	zem
脒	vdm
矊	fyz
臑	vrh
嬢	gfy
簰	kyu
鷿	njz
僄	mul
洴	osc
帲	zak
気	thi
鹐	qyz
揵	hxo
鉆	tla
塹	pla
鄗	cfe
篋	kak
嫀	gqw
欽	tnq
夋	otl
峵	elo
碝	uhk
颯	kbc
裇	lac
鯊	ohz
卲	mcj
泩	ons
澨	okk
檡	sci
糬	dca
泝	olz
痠	uol
曇	drt
綯	yfb
褅	lkz
貒	peh
尫	lvw
靰	zlu
枲	ojs
蟢	cpj
潟	oyx
峽	ekk
諕	ixb
僊	muo
俢	mli
銊	tie
烕	iex
鴨	gzn
巗	edl
讞	ixp
窯	rix
誼	ilk
斁	cal
勈	oei
浟	oml
娛	gjk
鋙	tvj
氳	tgc
蕓	brt
臓	vbe
鲗	zqp
鄫	vdf
牐	yxy
秖	wyv
摯	aih
螲	crg
跓	ezv
妝	ygn
衠	pnt
剚	mxp
曖	dil
瞹	fil
盫	gzc
邲	naf
倂	mak
缽	bse
駮	rfh
餔	wtf
鏟	tkn
瑺	qdz
珹	viw
喫	jqk
裭	lxb
齣	jks
豖	rzd
斶	lcc
骴	djw
荅	bgh
啗	jqy
癚	uqi
隄	fdh
髢	idy
菂	bnz
彫	gqi
啑	jxh
鼑	hfy
兠	nyk
枓	sld
饾	wad
敠	rrx
頞	lgt
弍	qte
騑	rpf
蟦	cut
剕	ppd
稃	wau
榑	stu
鵩	vcz
蝜	cqt
詌	iyg
筻	kpg
櫜	fls
貢	eft
熕	xet
榾	sdg
噑	jnu
鶴	crz
啈	jai
鴻	oez
撝	hax
昬	bdr
吙	jxh
攲	kxr
覊	uzr
輯	pjf
劑	psp
鐧	ted
薦	bax
僥	mal
噭	jnl
厪	wzt
橸	sdd
璄	qsk
駉	rgj
娵	gfr
秬	waa
玃	pfr
躩	efr
埈	aol
趷	etw
鏗	tea
刲	vpd
喹	jkv
醌	zdx
辢	pfx
梾	sps
嬾	gpt
瓓	qes
礧	ubb
孋	gea
俍	mzm
恡	nho
躪	ebr
囖	jkr
龒	eel
镥	tzd
琭	voi
嵂	ekx
傌	mrm
睌	fzk
蘪	bad
袮	lth
冖	ccc
覓	afk
嗱	jgh
儾	mfy
疒	uuu
眤	fnw
褭	yrm
挵	hvb
鬅	ivv
郪	xgf
綺	ykx
遷	uko
淺	oqq
鞦	zwx
鼽	dbm
綣	ymc
宍	lfl
楉	sbu
繖	yul
翣	nkg
姍	gyc
遈	dho
暏	dae
襩	lat
鉥	tsz
捒	hps
穟	wso
蓚	bmi
鞓	zjv
颋	vot
熥	xoo
駝	rlw
騨	rdu
榅	sdc
覀	uxx
鸂	oaz
呺	jje
銹	twv
痃	upy
喭	jki
熖	xay
鷃	dlz
钖	twi
恞	nki
迻	xxo
裛	yjo
曎	dci
蒑	bwt
闉	eua
穎	wwt
巊	efg
訧	idy
哊	juv
俁	mjk
琙	qqm
蕰	boc
醖	zdc
蠈	ftc
軫	pki
鳷	urz
幒	zsn
赒	qgq
呪	jjk
矚	fnc
髽	ika
襈	lot
妰	gra
鷟	ytz
鲰	zfr
抝	hyw
媼	ggc
蚆	cob
粃	dxb
猋	ppp
藨	bax
莂	bjp
檳	slt
癶	tbb
旵	des
兏	wik
鋿	tdj
撦	hka
摚	hda
掁	hei
黐	wkr
雔	rru
芻	fjj
摐	hkh
瘡	urj
綽	yhu
麤	aaa
蚮	cmq
黱	vms
癉	udu
筜	kdo
稲	wad
彽	kyz
敁	lxd
絰	ygi
饤	wrd
鼕	puf
簖	kdl
剟	rrp
椯	seh
粫	dhe
眆	fyf
倣	myl
髣	iyf
枌	stp
仏	mos
冨	cmb
鳆	ztl
絯	yph
阬	fpb
茖	bog
箇	kgx
浭	opg
塨	auh
蓇	bdg
颳	baf
坬	aag
蒄	bcu
珖	vdl
広	xos
嘓	jgm
嘷	jdu
傐	mcg
兞	xke
焃	xan
嗃	jcg
翝	lun
淴	ofn
搰	hdg
韄	zbr
譁	ibh
嫿	gxe
楻	snv
繪	ygd
譓	itn
撃	pth
鷄	ayz
穄	wtl
頬	mst
幵	euk
冿	fxv
揀	hps
聻	opf
曒	dnl
斠	wgl
巹	wia
菫	bmq
晉	eod
逕	ego
煚	dax
虡	xnt
呟	jpy
玨	vvw
駃	rak
馂	wol
摃	het
軻	pxk
勊	xki
歀	sln
籄	kat
壼	fen
闌	eps
簕	kzi
錅	wft
爄	xwr
靂	rwj
漣	opo
縺	ypo
膫	vkh
迾	xpo
醽	zrj
袊	lrl
巃	eee
擼	hzd
蘆	bxc
顱	xbt
媢	gdf
脢	vtn
璊	quk
冡	cer
憫	nec
耱	tsu
畝	pbz
幙	zlm
鮎	zla
毆	ajt
搒	hky
椪	ssn
狉	pje
狓	pzp
屛	nak
褀	loq
唘	urj
岍	eck
墻	aad
鄡	zsf
嵚	etn
魼	zao
鳈	zni
孉	gbr
蠸	cbr
緌	ywg
鄀	buf
弎	qos
渉	oja
嵵	edw
捜	hdr
潚	oxy
澻	oso
鐩	tso
傞	mie
蝪	cbi
騠	rdh
嚔	jfh
捵	hyt
脁	vkf
僣	mmd
桯	sjv
忳	nej
碢	udj
刓	tkp
愄	nby
鰃	zby
韡	hbh
抆	hcw
縰	ykh
幰	zln
県	fwh
訫	inx
騂	rfx
讻	ihg
敻	qgl
繡	yxy
鏽	txy
俆	mkw
珝	vnv
卹	acc
敍	kwx
続	yfk
諠	ilb
怰	npy
昡	dpy
絢	yfd
壎	axs
偱	mwf
馴	rgc
椏	sen
硏	uek
巚	exp
龑	eem
艶	yao
灩	oec
奍	mnd
餚	whv
薬	bns
蓺	baz
曀	dfa
営	djj
槱	szx
藴	byc
讃	imt
橧	svd
煠	xus
輾	pny
嚞	qqq
眐	fbe
篜	kwx
幀	zht
値	muw
瘃	urz
燭	xcc
贅	qpt
禚	lix
眥	jwf
嵕	ehl
罇	bzu
噯	jil
靄	rip
晻	dku
覇	uzv
朼	swb
佖	mna
愊	nmb
躄	nje
辧	fpf
麃	axh
鱉	wlz
癟	udy
髆	dtu
僝	mnu
諂	iqy
廠	xdl
弨	ima
巐	ecb
蛼	cpc
櫬	skk
歭	jws
漦	pli
抶	ham
鷘	plz
搊	hfj
踀	eeu
牀	ysm
垐	fna
巑	eft
獕	per
眔	cis
豋	tad
鄧	taf
廸	goy
厎	wyz
眱	fki
蹎	ent
澱	ont
矴	urd
墥	akm
対	cuc
頟	oty
灋	oao
繙	yib
癈	utt
翂	ntp
赗	qdf
怤	mun
栿	smp
雊	sru
唃	jqj
関	esm
俇	mpv
瞶	fct
腂	vbs
猂	pdk
熯	xuk
皥	ndu
毼	dfe
詥	igh
鬨	lut
昒	dfi
佪	mdh
邩	xfe
耭	tsk
叚	ntr
殲	xke
繭	bgc
膲	vrx
璬	vnl
錦	tnz
祲	lor
浄	oqx
烱	xgj
崌	enx
挙	dth
爠	xfr
絹	yjv
鴂	akz
覠	oak
矙	fel
槺	sxi
搕	hac
鞚	zre
懭	nxg
卼	lqc
餽	wgo
瀾	oes
覧	ekk
畾	bbb
磥	uby
壘	bba
栃	swp
隸	sli
瀝	owj
澪	orr
瑬	otl
綹	ylj
虜	xbi
瀂	ozd
睩	foi
蔍	bal
藘	bxn
寽	auc
緑	yoi
恾	nbp
冃	vyy
醿	zxy
冺	fbm
瞐	fff
抳	hnw
輦	mmp
孼	jau
囁	jff
嚀	jlr
紐	ywa
噥	jyz
穠	wyz
伮	mgr
矉	flt
顰	jhu
甁	akm
奤	ktm
踦	ekx
愒	ndp
譴	ico
鏘	tyu
耹	frw
淸	oqc
瓊	qql
腃	vmc
慤	fbn
礐	yhu
铷	tgj
壡	xta
鬖	ioi
槡	srs
鮹	zdv
絁	ytd
餿	wyr
玊	vzd
遡	sjo
膸	vuo
歳	jih
鏁	tgs
遝	cio
弾	idu
墵	art
矘	fds
蝭	cdh
菾	bmh
覥	ytk
炵	xlf
馱	rkd
槖	fus
跅	elz
塭	adc
洿	oke
乄	hii
阢	flu
狶	phz
觹	qrg
祫	lgh
胘	vpy
玁	pdl
綫	yqq
鑲	tyw
鮝	mzv
咲	jsm
衺	yay
攜	hej
褉	lqk
瀉	olx
鉶	tcp
夐	qgl
獝	pcj
吅	dhh
矎	fql
薫	bxx
鄩	oef
犽	pay
揅	uch
鹽	etc
鴈	wmz
僷	mbs
瞱	fbh
椸	syd
觺	wvq
枻	suw
殹	avt
霬	rbt
埇	aoe
忬	ncv
悁	njv
抈	hvy
畇	bff
筼	kjq
隕	fjt
賬	fte
侲	mzc
謢	irr
鴙	vzn
擲	hzf
箒	koz
晝	xde
椓	srz
牸	flu
綜	yll
珇	vkq
晬	dpu
啽	jgb
貋	pdk
鷔	qpz
昄	dwr
棓	skj
骲	dfo
糒	due
禆	lgu
鷩	wlz
灬	xhh
驃	rul
濱	olt
瀕	ojt
抦	her
袚	lur
浡	ofu
葧	bfi
埗	ajh
跴	eux
懆	njs
惻	nfp
査	skq
懺	nke
巣	dbs
謿	iuv
屮	jcc
茞	bec
鉓	ttz
篘	kfj
籌	kau
摴	hre
瑏	qra
惷	qdn
庛	xjw
啛	jxg
鴏	zmq
蜑	ajc
儅	mdb
蟷	cdb
苖	bgy
阺	fyz
呧	jyz
鈿	tbt
萣	blh
働	mxi
読	ifk
讟	iai
礬	chu
馩	wdt
鏠	tlo
刜	inp
柫	sin
韨	hur
襆	lnz
襥	lmz
郙	tfe
蜅	ctf
冮	feg
皐	nfu
塥	aug
獦	pbp
亙	eve
兝	xkp
冎	dgg
剮	djp
瞆	fcq
禬	lgd
盇	kzc
鋘	tjm
瑍	qqk
鱑	zug
鮰	zdh
圂	grs
喞	jnc
禨	lyk
譏	iyk
蝍	cmc
浹	okk
鰜	zsn
鬋	isp
踐	eqq
壃	aee
菨	bkg
稭	wxn
尐	hzd
璥	vbl
弪	ire
奺	gqz
鷲	chz
眗	fsj
岠	eaa
跙	ekq
鉅	taa
愳	ffn
鵑	jvz
睠	fmc
餋	mws
晙	dol
駿	rol
摳	had
扝	hee
睞	fsk
襴	les
籣	kes
躝	ees
覽	ekk
欖	sek
撈	hxi
楽	nfs
儽	mby
涙	ozk
碐	ual
剺	plp
犛	plf
蠣	cwr
鬑	isn
湅	ops
憭	nkh
遼	kso
挒	hxp
鱲	zgy
痳	ucl
驎	rda
躙	eer
琌	qew
磂	uyb
珋	vym
塿	ajg
玈	pyy
熝	xal
膔	val
鋁	tjj
矕	iyf
苺	bnm
凂	fzk
濔	oth
謀	iys
娚	gbi
莻	bvw
晲	dyk
裊	zyi
躡	eff
磗	utu
硑	usc
閛	eks
澼	onf
嚬	jjt
痡	utf
镤	tnz
竒	kjc
璂	qoa
邔	afe
嵰	esn
嶈	eyu
駸	ror
澿	ocl
頃	wty
虯	ccj
渞	osd
籧	kxo
辁	pkv
崅	eqj
韌	hpz
駥	rqu
簁	kkh
陝	fkk
傓	mzn
椫	svu
紳	yds
昚	ksd
榺	vms
鰤	zaz
铈	tpz
収	cry
鄃	gvf
綀	yps
婌	gir
礵	urf
駟	rcs
螋	cyr
驌	rxy
逤	oho
闒	edn
鞳	zbg
襨	lnu
怹	mdn
啴	jvu
赕	qxx
絛	mcy
脦	vqn
闐	ent
覜	kfk
呫	jla
嵉	ecr
穜	wkm
糰	dgu
頽	wbt
襪	lbz
芛	boa
骫	dmz
唩	jwg
撾	hdo
禑	lbr
鷡	czn
肸	vtu
唽	jsl
犠	fiq
酅	erf
矖	fea
孅	gke
硍	umg
嚮	yzj
屟	nus
僁	min
褻	yaz
邤	lfe
舋	ygk
狌	pns
煋	xdn
堐	awv
篶	kbx
塩	atc
巌	edl
揜	hgb
檿	wds
眏	fgk
昜	bfi
敭	bfl
鍚	tbi
楧	sbk
窰	rab
騕	rug
枼	uws
馌	wac
鹥	avz
扅	zxx
頤	ety
衵	ldr
軼	pam
慭	psn
覮	xxk
灐	oxt
楡	skg
嶼	eyt
瘉	ugp
隩	fsk
鴥	zrx
鐭	tsk
伝	mty
褞	ldc
腪	vcp
醩	zyd
鑿	nit
柤	skq
搾	hrr
饘	wpb
盄	icc
詔	ima
櫂	snr
葴	bim
掟	hlh
禃	lni
躑	ezf
疐	fbh
泈	olf
诪	iqu
紵	ylr
晫	dhu
胔	jwk
総	ytn
諏	ifr
捘	hol
莋	bmr
岞	era
咗	jue
啀	jwv
藹	bip
垵	alg
翺	dfn
岰	eyi
胈	vur
媬	gms
萡	bon
琫	vqh
跰	esc
柲	sna
聛	fgu
詖	izp
萹	bzy
儦	max
蟞	wlc
髩	iew
鬢	ilt
偋	mnc
孹	nju
埰	aic
飡	fws
慚	npl
犲	pua
湹	owm
欃	szz
漅	ogs
俥	mpc
磣	uoi
虰	crd
誠	iiw
憕	nta
鴟	yvz
鵄	gzn
糦	dpj
鶒	piz
埫	adj
紬	ygy
臅	vcc
巛	gcc
瑽	qkh
従	ksh
誎	ips
縗	yyt
綷	ypu
竴	kzu
醝	zie
迖	pod
呾	jbd
逹	aio
恴	pdn
滌	oms
汈	owe
凟	fat
瀆	oat
嚲	cuu
堮	ade
齶	jke
薾	bth
邇	tzo
閥	emq
販	ftr
奜	pkd
瀵	odt
僼	mya
鳯	bzn
玞	vmf
柎	smu
衭	lmf
郂	pfe
亁	udw
骭	dkg
棡	sge
鴿	gzn
畊	bwj
骾	dpg
泒	oag
罛	cag
祻	lgx
観	tek
鑵	tbr
撗	hug
帰	poz
烸	xtn
哻	jdk
甝	xby
鋡	trj
屽	ekg
蠔	ccr
抲	hxk
哬	jmx
鶡	dfz
閧	eut
膴	vcu
楜	sxv
姡	gfs
蘹	bni
狟	peb
逥	gjo
瘣	ugo
諱	ihw
騞	rqu
臛	vrr
鳮	rzn
齎	pst
蕀	bnn
覬	eak
玾	qgj
鳽	czn
澗	oed
瞷	fed
艦	lec
鳉	zyu
挍	hfh
卩	cjj
詰	iqj
毑	ndy
觧	qiy
凚	fcl
痙	uee
誩	iiy
捄	hiq
跔	esj
鵙	ftz
鋸	tnx
瑴	fev
蹷	wse
戄	nfr
鈞	tff
偘	mjd
墈	aoi
揢	hlo
嵑	edp
鷇	fez
梡	slk
誆	iav
媿	ggo
柆	skl
庲	xsk
斕	ces
壈	apw
硠	uzm
朖	vzm
癆	uxi
貍	pml
廲	xea
娳	gwp
嗹	jpo
鬛	iys
粦	dxa
隣	fda
僯	mda
懰	nyp
飀	bab
罶	cyb
霤	ryb
漋	ofn
遱	juo
磠	uld
膢	vjg
攣	iyh
纙	ycr
霡	rvi
悗	nzk
汒	opw
蠎	cbb
匁	apz
貿	yft
脄	vux
愐	ntm
苠	bbm
莈	bot
麰	skf
莯	bos
撓	hal
筽	kjm
蒎	qwy
媻	ltg
蹣	euk
伓	mjb
氕	tap
頩	sct
廹	noy
慼	iin
磜	utl
繈	yic
懃	ztn
搇	hry
訄	miy
唒	jzy
蠤	zcc
鼩	ysj
灈	ofr
牷	fkv
埢	amc
亽	rll
袇	lgp
姌	gga
獽	pyw
壌	afy
仭	mpz
驲	rdr
氄	cge
楺	scs
耎	hkd
喢	jxy
賖	ftw
舎	kqj
懾	nff
腎	erv
苼	bns
蝨	wuc
鸀	cfz
涗	otk
箾	kdp
虒	wxb
罳	cbn
罒	css
覗	wmk
睟	fpu
潠	oot
簔	kyu
颱	baj
铴	toi
劏	djp
鵜	sqz
洟	oki
跕	ela
驖	ruv
庝	xlf
膧	vkm
亠	ppp
猯	peh
慱	ntu
蹆	emo
蛻	ctk
焞	xcu
喎	jdj
睕	flc
踠	elc
硊	uqc
蒍	bzx
僞	max
煟	xbv
絻	yzk
暡	dtn
仴	mvy
鹀	ekz
睎	fhz
錫	tdi
塈	mca
澙	oyx
嚱	jxq
轄	plj
秈	wes
銜	ptj
饗	yzw
嘐	jni
謞	icg
峫	eaf
脋	ppv
灺	xdy
伈	mnx
郉	euf
蘐	bir
娫	gao
暘	dbi
颺	bai
榚	six
葯	byz
匜	ady
柂	std
佁	moj
帟	qzj
勚	uwi
獈	psc
縊	ysc
檍	ssn
豷	rfa
饐	wfa
犾	ppq
珢	vmg
婬	gav
鮣	zyc
巆	exj
鞕	zpg
槦	sxe
噰	jpr
嚘	jtl
庮	xzy
铕	tuv
狖	prx
砡	ulv
薁	bsk
蚖	ctk
蝯	car
矱	vbr
鈅	tvy
涢	ojq
雑	msr
兂	cuu
柵	syc
鳣	zpb
棧	sqq
埑	hla
碪	uow
裖	lzc
眹	fsm
箏	kax
祬	lgi
抧	hjt
墆	abz
礩	ult
淍	ogq
謅	ifj
咮	jap
僽	mwn
鋳	tqu
鵫	hdz
漬	oqt
棸	frs
籫	kft
祽	lpu
檇	srg
餲	wdp
諳	isy
洝	olg
垇	age
癹	tts
跁	eob
挀	hwy
薭	bwu
褩	lty
幇	vuz
牓	yky
琲	vpf
柀	szp
貶	ftb
虌	bwe
冫	fbb
馞	wdu
蘗	bns
鳪	hzn
咘	juz
戝	ftq
黲	soi
凔	frj
摻	hoi
闡	edu
烢	xlv
諶	iow
庱	xal
恜	nqe
懤	nau
櫉	swu
鶵	fjz
舩	lto
歂	ehn
汌	ogc
醕	zcd
逴	hdo
擉	hcc
茦	bnb
噈	jcd
皠	ner
脃	vqo
墶	aao
荙	bko
躂	eao
襶	lut
酖	zck
帎	zck
窞	rqy
瓽	djm
鍀	tbu
玓	vfz
嶳	era
蒧	bil
窵	rzn
詄	iam
颩	bai
蕫	bkm
闘	eau
竇	rat
仛	mav
喥	jxr
鐸	tci
躱	gvs
鵞	hqz
蕚	bje
陑	fhe
鲕	zhe
髪	iur
訉	ibz
盕	obc
坆	alx
蚠	tpc
缻	bmw
帗	zur
輻	pmb
姟	gph
忋	naj
汵	orw
檊	suk
矼	ueg
藳	bcw
筶	kfj
誥	ifj
裓	lqb
觡	qog
菮	bxk
嗰	jmx
羾	neg
簼	kha
唂	jcg
軱	pag
鮕	zxg
淈	ong
騧	rdj
叧	jpd
罫	cvh
覌	rfk
閨	evg
膭	vct
庪	xhr
劊	gdp
彍	ixg
虷	ckg
鋎	tlk
雗	udr
妔	gpb
籇	kcr
灴	xeg
宖	lio
錿	txb
鳠	zbr
糀	dbw
懐	npy
壊	auy
嚾	jbr
偟	mnv
揘	hnv
艎	lnv
穔	wug
兤	dlg
榥	sdl
暉	dcp
睳	fkv
褘	lhw
噅	jax
燬	xyt
橞	stn
焝	xyd
偮	mjf
耤	tsd
鷑	kkz
鮆	jwz
檵	syw
榎	stl
葏	box
箋	kqq
緘	yim
篯	ktq
梘	sfk
瞼	fgk
瀽	ole
絳	yla
畺	ebe
鵁	fhz
鷮	mjz
繳	ynl
譑	imj
煯	xxn
鶛	xnz
刦	aop
袺	lqj
枃	sff
頚	rat
冋	gjk
廄	xmt
砠	ukq
腒	vnx
駒	rsj
鴡	kzn
鶋	nxz
犑	ffp
怚	nkq
飬	mzm
屩	nkj
亅	css
趹	eak
鶌	njz
垰	aih
鱇	zxi
邟	pbf
薖	bdo
頦	pty
礚	ubc
渇	odw
涳	ore
瞉	fef
絝	yke
誑	ipv
鵟	pvz
鄈	tmf
煃	xkv
樻	sct
鵾	dxz
霩	rcf
倈	msk
顟	nkt
耮	tsi
塁	bfa
讄	ibb
鸓	bbz
棃	wfs
斄	plk
砅	uis
蒞	bok
暦	wcd
鴗	kzn
犡	fwr
皪	nns
礫	uns
攦	hea
慩	npo
魎	gok
竂	rkh
簝	kkh
浖	oau
睙	fzp
鏻	tda
廩	xpw
癝	upl
鹠	ybz
耬	tsg
螻	cjg
鏤	tjg
滷	old
勠	nki
踛	eaa
驢	rxc
哷	jau
鵅	ozn
嫲	gxc
犘	xcf
祃	lrm
髳	icm
嚰	jxu
呅	jcw
鋂	ttn
蝱	pcc
鯭	zuc
幎	zcf
濗	olz
黽	eei
蠠	tcc
謩	liy
劘	xcp
慔	nlm
廼	uoy
褦	low
儗	mwh
惄	ihn
鸋	lnz
儂	myz
笯	kgr
駑	grr
鳑	zky
麅	afo
毰	ekj
漰	oev
錋	tvv
翍	nzp
礕	nju
闝	efl
砯	uzi
帡	zsc
箁	kkj
掑	hoq
鵸	kxz
鶀	zoq
岒	erw
扲	hrw
鉗	tyg
繾	yco
斨	ylj
蹌	erj
癿	nwe
嶔	etn
抋	hnx
卭	ecj
瞏	cay
逎	zod
銶	tiq
岨	ekq
烇	xkv
韏	mhw
搉	hcr
羣	oai
遶	aao
魜	zkr
纴	yvw
鴽	gjz
醹	zrh
鱬	zrh
堧	ahk
愞	nhk
慅	nrc
氉	jde
篸	koi
幓	zoi
澘	ocd
晱	dxx
墠	adu
殤	xti
觴	qti
虵	cdy
頣	ety
瑡	qaz
旹	jed
疎	hps
橾	sjs
鮛	zih
藷	bia
誜	iol
灀	orf
糹	yss
慫	kkn
訟	ito
醙	zyr
藪	bjl
傃	mqy
鋉	tps
飱	xws
嗩	jdt
榙	sbg
涾	oid
禢	ldn
痑	uxx
嘽	jdu
襢	lpb
舕	fxx
鞺	zda
嵣	exj
漟	oda
赯	anj
幍	zay
匋	fbf
膯	vta
謄	vmi
虅	bvr
恌	nkf
芀	bpd
蓨	bmv
鯈	mcz
誂	ikf
怗	nla
鐡	tus
楟	scr
娗	gvo
氃	kme
慟	nxi
敨	kjl
捸	hxi
鼵	yrp
鵌	zkw
迌	vod
鵵	zkz
団	guc
鏄	ttu
穨	wbt
黗	sej
陁	ftd
紽	ylw
橢	sfv
搲	hra
輓	pzk
嶶	ekb
痏	uuv
蔿	bax
轀	pgc
猧	pdj
捰	hbs
弙	ieu
汚	otw
扤	hlu
悮	njm
忚	ndy
赥	ann
搳	hlj
杴	snq
纎	yue
嫺	gev
臽	qyj
僩	mev
饟	wyw
啋	jic
絏	yda
夑	ixl
盺	flj
諝	ihv
咺	jeb
眴	ffd
澩	yhi
吷	jak
勛	jfi
潯	oou
殾	ats
崕	ewv
穵	rwi
莚	bao
綖	yao
扊	zxx
騐	rrn
炴	xgk
抭	hlb
鴢	yiz
敼	pjx
伇	mts
忔	ntw
埶	atz
歝	can
驛	rci
粌	dic
茚	byc
癊	uft
濴	oxi
矨	vmt
浧	ojv
廮	xfg
栐	szi
滺	omn
輶	pzq
紆	yeu
歈	gvn
羭	igp
輿	ypt
悆	kwn
焴	xtv
蒮	bcr
繘	ycj
醧	zad
鴛	xcz
鵷	lxz
厡	wni
縁	yor
羱	iwh
衏	ptk
禐	lar
禴	lgy
篔	kjt
殞	xjt
磼	urs
洅	ona
灒	oft
駔	rkq
歵	jqt
鋥	tjv
迊	ezo
齄	dbb
閘	egj
醡	zrr
斎	cnl
嶦	eqi
桟	see
轏	pnu
窼	rgs
悊	hln
殝	xqw
鍖	tow
炡	xbe
聇	fbe
氶	wis
坧	aus
徏	kjh
銍	tgi
懫	nlt
鱄	ztu
籑	kfm
餟	wrr
稕	wcu
琸	qhu
叕	rrs
斵	yel
鼒	uay
鶅	gbz
齜	jkw
呰	jwj
胾	uqk
緅	yfr
踤	epu
秨	wra
筰	kmr
皚	nea
僾	mil
懝	nwh
侒	mlg
媕	ggb
柪	syi
謷	qpi
鼇	qpe
芺	bmt
驁	qpr
哵	jjp
羓	iob
朌	vtp
玤	vqf
桮	sjj
倴	mkb
綳	yvv
琣	qkj
疕	uwb
滭	obh
箆	kgx
馝	wda
鄨	wlo
贔	ftt
猵	pzy
爂	ygx
鑣	tax
鼈	wle
霦	rci
陃	fer
鉼	tsc
餠	wak
蹳	ett
胉	vnb
箥	koz
鸔	zdi
箣	knp
梣	sew
笒	krw
梴	sao
蟬	cdu
嚵	jzz
瀺	ozz
懴	nue
伡	mpc
迠	lod
硩	hlu
謓	int
讖	ike
朾	srd
娍	giw
筬	kiw
鋮	tiw
瀓	okv
趍	dxx
胣	vtd
漴	oel
鋤	tki
檚	sch
膗	ver
窻	rsn
漘	ozv
踳	eqd
辤	irf
餈	fnw
薋	bft
朿	nbb
蟌	csn
藂	bfi
趗	deu
慛	ner
膵	vbu
刐	gpp
撣	hdu
僤	mdu
襠	ldb
魛	zpd
惪	nnx
璒	vta
鸐	nrz
諦	ikz
槙	snt
巓	ewt
蜨	cxh
眰	fgi
奵	grd
犢	fat
靯	zat
祋	lts
懟	nin
噸	jet
朶	vsm
咢	dee
堊	ena
搤	hsc
児	cdk
耏	his
輀	phe
餌	wfe
駬	rfe
刵	fpd
咡	jfe
旙	yib
蠜	chc
嬎	gzn
趽	eyf
婓	pgn
馡	wdp
厞	wpf
鼣	ypq
溄	oeh
犎	vuf
鄷	yaf
夆	lqf
覅	ugi
砆	umf
荂	bke
禣	ltu
輹	ptl
玍	tat
峐	eph
皯	zkg
鳡	zin
贛	sut
戇	sun
餻	wix
鼛	puj
槀	csm
犵	ptw
鞈	zgh
挭	hpg
鯁	zpg
厷	uos
兣	xkm
耇	asj
鼔	pxd
棝	sgx
鲴	zgx
焻	xdd
煱	xdj
緺	ydj
爟	xbr
椝	mes
氿	omj
垝	aqc
溎	osv
鱖	zwn
鮌	zpy
圀	gty
褁	bsy
駴	rqb
凾	tjg
暵	duk
獆	pnu
皜	ncg
頜	gty
覈	unl
寉	lru
脝	vct
谾	cre
耾	fuo
虖	xau
芐	beh
撶	hbh
觟	qvg
樺	sbh
寏	lqk
綄	ylk
貆	peb
豲	rwh
渙	oqk
煥	xqk
瘓	uqk
瑝	vnv
晄	ddl
烣	xux
賄	ftv
誨	itn
暳	dqo
獩	pjh
謋	ixs
夻	kjk
筓	kek
觭	qkx
韲	pse
鶏	amz
齏	pse
彐	oww
継	ydw
暩	dtl
薊	bzp
鵋	anz
齌	psx
癠	upt
裌	lkk
莢	bkk
賈	uft
麉	kka
瑐	qsp
剣	gkp
瞯	fev
摪	hyu
螀	yxc
醤	yaz
勦	gbi
撹	hdk
呌	jld
皭	nau
椄	skg
刼	aoz
衱	lrj
迼	qod
訐	ikg
吤	jkn
浕	onf
賮	xet
秔	wpb
鶄	qvz
麖	ach
鼱	yqv
妌	gwj
脛	vee
絅	ygj
鳩	mzn
倃	mlj
廐	xmc
洰	oaa
埧	akt
焣	frx
裐	ljv
鋗	tjv
砄	uak
鐍	tcj
钁	tfr
箘	kgw
鉲	tih
闓	eea
忼	npb
匼	agh
桍	ske
洭	oav
蘷	bul
躨	esl
噋	jcl
鬎	ipp
攬	hek
崀	ezm
唥	jfr
労	dil
髝	cxi
韷	sjg
傫	mby
礨	bbu
倰	mal
謧	ipr
鯉	zml
涖	omk
凓	fus
棙	szp
癘	ubr
禲	lwr
溓	osn
燫	xxn
瑓	vps
纞	yin
嵺	eni
嶛	ekh
撛	hda
澟	opw
昤	drl
掕	hal
祾	lal
軨	prl
癅	ueb
蕯	bfn
聾	eef
婁	jug
溇	odg
瓐	qxc
臚	vxc
纑	yxc
稑	waa
賂	fto
輅	pog
簶	kli
馿	rzh
氀	jue
灤	ois
癵	uik
埨	agy
禡	lrm
慲	nuk
澫	obr
笀	kpw
蛖	cui
枆	sem
錨	tbb
鄮	yff
甿	bpw
溕	ocr
夣	tcx
沕	ofi
覔	jfk
謐	inc
簚	kcz
敃	blx
僶	mee
帞	zub
眜	fpm
粖	dpm
纆	ysa
鉾	tof
袦	ljg
抩	hga
嚢	fty
訥	irn
鯢	zyk
柅	snw
愵	nif
秥	wla
醸	zfy
聶	fff
糱	jad
寕	ler
擰	hlr
濘	olr
沑	owa
膿	vyz
醲	zyz
癑	uyz
獳	prh
儺	mur
縏	lty
鋬	hwt
礮	urh
匉	fks
弸	ivv
掽	hsn
磇	usx
駓	rje
礔	unf
膍	vsx
篺	khu
羆	cox
媥	gzy
腁	vak
縹	yul
飃	bal
皫	nax
甹	gek
荓	bsc
塀	anc
缾	bsc
岥	ezp
砶	unb
圤	ahb
蒱	bht
錡	tkx
鲯	zoq
鬐	iad
騹	rzt
裿	lkx
栔	qps
摖	htl
鉛	tbj
慳	nea
鵮	qyz
忴	nrw
傔	msn
棈	sqv
漒	oic
薔	bad
繦	yic
鍬	twx
趬	dal
僑	mmj
蕎	bmj
陗	fdv
綅	yor
儬	mqk
笻	kec
璚	qcj
阹	fao
粬	dyq
誳	ing
髷	iyq
胊	vsj
覻	xak
婘	gmc
毃	cts
纕	yyw
懹	nyw
讱	ipz
扨	hpz
軔	ppz
鶔	csz
韖	hcs
蕠	bgy
燸	xrh
扖	hkr
緛	yhk
瓀	vrh
溞	orc
鳋	zrc
髞	cjs
琗	qpu
嗇	akd
箑	kxh
篩	kaz
繕	yij
慯	nti
丄	cei
弰	idv
慴	nnn
蠂	cbs
柛	sds
駪	rfk
邥	ckf
宷	lic
剰	wup
琞	dvl
鲺	zwc
鼫	yus
揓	hyd
獣	dbp
杸	sts
尗	ihx
鏣	txx
閂	eei
艭	lrr
鉰	twm
餸	wso
蓃	byr
樕	spn
蹜	elu
夊	lxx
嵗	eih
檖	sso
璲	vso
巺	oot
惢	nnn
搨	hdn
毾	dne
檯	sqg
罎	bdt
煻	xxj
偒	mbi
儻	mds
縧	yms
鞉	zkf
貣	qft
漛	omi
蹏	ewb
倎	myt
鲖	zgm
偸	mkg
媮	ggp
鍮	tgp
鷵	naz
摶	htu
漙	otu
湪	oor
隤	fct
旽	dej
朜	vcu
芚	bej
豘	rej
咃	jmd
駞	rtd
鼃	vee
邷	mfe
顡	krt
抏	htk
唍	jlk
盌	xcc
翫	nnk
錽	tel
兦	pww
忹	nvw
覣	wgk
椲	shw
緯	yhw
鮪	zuv
衞	paz
褽	nly
輼	pdc
忟	ncw
穏	wan
郚	vjf
莁	bek
瑦	qzn
嵍	cle
悕	nhz
渓	oam
翖	gnv
徯	kak
誒	iov
豀	cak
雟	jrj
觿	qej
赩	ano
谺	cay
颬	baa
廈	xtl
枮	sla
衘	pbf
諴	iim
尟	dha
憲	lqn
錎	tqy
鼸	ysn
郷	ymf
啌	jre
餉	wsj
龤	gdn
禼	lhr
屧	nks
薢	bqf
躠	bae
噺	jkl
娙	gee
詾	ifg
诇	igj
旴	deu
盨	itc
侐	mac
翧	len
癬	uzi
铔	ten
蕥	bar
襾	uxx
婭	gen
嵒	jde
黤	sku
曕	dqi
崵	ebi
煬	xbi
鸉	sbz
猺	pab
仸	mmt
苭	byi
鎁	tff
擪	wdh
郼	hfe
毉	avk
乁	zdd
誃	ixx
鏔	tlg
迆	dod
苢	bdh
旑	ykx
兿	sht
熤	xnk
繹	yci
醷	zsn
韾	ans
訔	eiy
龂	alj
蟫	cuu
鷣	udz
螾	clg
媖	gbk
嚶	jfg
攖	hfg
鶯	xxz
鸚	ftz
溋	ovc
癰	ugr
傛	mlc
禜	xxl
鲉	zgy
牗	yxe
邘	euf
歟	yen
敔	vjl
魊	gom
渕	osp
獂	pwh
蚎	cdr
呍	jty
抣	hff
磒	ujt
枟	sty
桚	sgx
鉔	taz
鐕	tcd
偺	mld
崱	efp
苲	bra
嶄	epl
粻	dei
佋	mma
桭	szc
鉁	tki
癥	ukv
汦	oyv
淽	obj
阤	fdy
柣	sam
猘	pfp
跱	ews
籦	ktm
煄	xxm
鸼	lzn
軸	pgy
縐	yfj
泏	ojg
秼	wap
膞	vtu
転	pty
膇	vao
諄	icu
斮	udl
斀	cfx
灂	oau
貲	jwt
稯	whl
鬉	ihl
鏓	tsn
爼	hhk
鑚	tmt
嗺	jer
蟕	cjq
酔	zmu
噂	jzu
溰	oea
昹	dzi
硋	uph
鴱	bhz
鑀	til
靉	rtl
鞌	lgz
鮟	zlg
岇	eyc
軪	pyi
镺	imt
釟	ttb
瓪	mwr
湴	osn
靽	zsh
垹	aqf
謗	iky
寳	lqt
鑤	tdi
犕	fue
誖	ifu
骳	dzp
賁	ubt
伻	mks
祊	lyf
埲	aqh
塴	aev
鵖	mzn
坒	xat
煏	xmb
蓽	bbh
飶	wna
罼	cbh
襅	lbh
廦	xnf
篳	kbh
躃	enf
魓	goh
覍	hfk
閞	eob
頨	nty
骉	rrr
臕	vax
飈	bax
汃	otb
鬂	ilt
殯	xlt
栟	ssc
苪	ber
竝	kkl
盋	urc
碆	ozu
郣	fuf
瓟	afo
猼	ptu
豰	fer
簙	kuu
鎛	ttu
譒	iib
峬	etf
郶	kjo
喰	jws
傪	moi
慙	pln
蠺	mmc
濸	obj
鶬	rzz
敇	nlx
揷	hxy
鑔	tll
紁	yrz
詫	ilv
喍	jjs
袃	vpy
幨	zqi
儃	mpb
幝	zdu
譂	idu
锠	tdd
鼚	pue
鱨	zdd
鄛	gbf
窲	rdl
鼂	bee
麨	ska
瞮	ftl
浾	oan
頳	ant
窚	riw
碀	uqx
騁	rge
粚	dtd
泜	oyz
遅	nio
叺	jkr
徸	kkm
隀	fxm
皗	ngq
酧	zlu
薵	bau
讐	rri
蒭	bfj
幮	zxu
櫥	sxu
埱	air
歜	cfn
篅	keh
鶨	orz
牕	ysn
埀	xyt
鶞	wuz
犉	fcu
蓴	btu
辵	ihf
娕	gps
鷀	syz
蛓	uqc
螆	csy
囪	siz
茐	bfz
楤	sfn
暰	dkh
聦	ffn
孮	ull
輳	pqm
觕	fqj
憱	ncd
簒	kfo
鏙	ter
趡	dru
膬	vee
顇	pkt
墫	azu
澊	ozu
刌	upd
籿	duc
鹺	lde
銼	tka
剳	bgp
龘	eee
紿	yoj
貸	mqt
靆	rto
妉	gck
単	dbu
勯	pdi
憺	nqi
簹	kdb
趤	dlu
璗	obl
蘯	boc
舠	lpd
禱	lau
瓙	qax
悳	ufn
嬁	gta
鍉	tdh
嚁	jnr
詆	iyz
杕	skd
逓	wto
祶	lsq
蔕	bbz
蝃	crr
遰	bco
甋	kgm
齻	jkt
婰	gyt
鳭	pzn
藋	bnr
眣	fam
耊	agi
惵	nus
臷	uqg
諜	ius
铥	tvo
昸	dlf
埬	ape
挏	hgm
湩	oxm
詷	igm
剢	rzp
匵	aat
贕	yat
痽	uru
譵	inu
橔	scl
躉	bbe
潡	ocl
挆	hbs
刴	vsp
墯	nua
鵽	rrz
娿	fxg
涐	ohq
搹	hug
僫	men
蝁	enc
閼	eyf
貳	qtt
茷	bmq
藅	bcp
橎	sib
仮	mwr
辺	pod
奿	mzg
瓬	ymw
鶭	yyz
帉	ztp
鳻	tpz
燓	chx
膹	vut
盽	fqf
桻	slq
猦	pbc
馮	frm
湗	ovu
垺	aau
鴀	jzn
妋	gmf
胕	vmu
鳺	mzn
糐	dtu
玸	qfo
虙	xna
綍	yfu
鴔	abz
鶝	mbz
弣	imu
釡	ttj
焤	xmx
訃	ihb
蚹	cmu
萯	bqt
蕧	bkl
荄	bph
摡	hmc
槪	snc
瓂	qbc
粓	dyg
簳	kuk
紺	yyg
堽	acb
鷎	nkz
菒	bds
稾	cwh
祰	lfj
鴐	ijz
滆	oug
鮯	zgh
轕	pbp
縆	ynb
喼	jqn
愩	net
鞏	ebz
撀	anh
箛	kua
轂	fep
鶻	dzn
薣	bpr
鵠	fjz
怘	xnx
啩	jvh
炚	dxh
硄	udl
瞡	fmk
鮭	zvg
鬶	meu
佹	mqc
恑	nqc
觤	qqc
攰	uri
撌	hct
簂	kgm
襘	lgd
緄	ydx
謴	int
鈛	tqg
摑	hgm
頇	kty
譀	iwl
鶾	udz
椃	sxb
恏	gun
欱	gnq
鉌	twh
閡	eph
爀	xan
胻	vpx
渹	ofi
妅	geg
谹	cuo
葓	bot
晎	dut
銾	tei
翭	nmv
轷	pau
雽	rau
歑	xan
瀫	ofy
鶦	xvz
滸	oiu
箎	kxb
枑	seo
嫭	gxu
芲	bkw
婲	gbw
蘤	bnx
畵	xbg
褢	ygo
褱	yci
闤	ecy
鐶	tcy
媓	gnv
廽	gjo
螝	cgo
阓	ecq
彚	ocs
璯	qgd
翽	jin
譮	igd
涽	oyd
惽	nbd
棔	syd
鼲	ycp
掍	hdx
眓	fiu
掝	hqm
雘	gpr
瀖	orr
矐	frr
嗘	jak
磯	uyk
賷	fdt
饑	wyk
羇	czx
鸄	nyz
卽	nwc
塉	afv
檝	sjq
濈	ojq
鶺	ffz
妀	agn
惎	onx
兾	sbt
痵	uwu
誋	ian
鯽	zmc
鰶	ztl
抸	hab
餄	wgh
鴶	qzn
斚	ool
幏	zlr
熞	xea
蕑	bev
熸	xcd
覸	edk
戩	eoq
儉	mgk
鰎	zxo
徤	kxo
臶	guu
跈	eki
榗	sed
趝	drn
諫	ips
檻	sec
鑒	ekt
鑬	tek
勥	iji
奬	yvk
夅	lay
弶	ich
嘄	jzs
轇	pni
湬	wxi
餃	wfh
儌	mnl
矯	vmj
鱎	zmj
窌	rym
敎	hul
潐	orx
釂	zau
脻	vxh
昅	drj
蛣	cqj
楬	sdp
擳	hkc
伒	mlj
煡	xxo
墐	azt
濅	olr
壗	axc
贐	ftc
巠	ege
鵛	egz
鯨	zch
丼	wzd
憼	bsn
俓	mee
逈	sjo
浻	ogj
揫	wxh
麔	alj
欍	sby
泃	osj
梮	snj
艍	lnx
鮈	zsj
椈	sfd
毱	efd
蹫	ecj
鵴	fdz
鼰	yft
弆	aob
齟	jkk
怇	naa
窶	rjg
弮	mig
勌	mci
慻	nmf
撧	hyo
泬	orx
焆	xjv
瘚	usn
蕝	byo
鴃	zak
蟨	wsc
觼	qql
鷢	wsz
汮	off
愷	nea
鍇	txn
栞	eus
龕	gee
冚	ces
堿	aim
欿	qyn
顑	imt
砊	upb
穅	wxi
匟	apb
囥	gpb
銬	tae
钶	txk
醘	zac
褃	ljv
硜	uee
宼	ltg
簆	klx
跍	exg
俈	mfj
晇	dke
旝	ytd
窽	rwn
抂	hvw
匱	act
謉	igo
菎	bdx
鯤	zdx
稛	wgw
筈	kfs
髺	ifs
鞟	zcu
鞹	zcf
攋	hpt
櫴	spt
鑞	tgy
徠	ksk
猍	psk
騋	rsk
鶆	skz
厱	wgk
懢	nec
幱	zes
囒	jbs
窂	rfn
哰	jlf
铹	tyi
朥	vxi
恅	naw
砳	uus
餎	wog
虆	bby
絫	ooy
癗	urb
颣	dyt
纇	dyt
艃	lml
樆	spr
穲	wea
鱧	zya
屴	eil
茘	bpp
悧	nwp
厤	www
歴	wcj
綟	yzp
濿	owr
曞	dwr
盭	yac
鷅	usz
轣	pwj
靋	roj
嫾	gda
亷	kwn
籨	kgn
稴	wsn
澰	ogk
錬	tpe
瀲	ogl
簗	kos
緉	yek
膋	xxv
璙	qkh
挘	hhi
姴	xpg
烮	xpx
惏	ncl
麐	acj
橉	sda
朎	vrl
秢	wrl
魿	zrl
霝	rdj
齢	jdr
櫺	srj
疁	bni
瀏	oyp
鶹	ybz
栁	sxc
槞	sku
蘢	bee
壟	eea
攏	hee
竉	ree
謱	ijg
鈩	tzh
艫	lxc
鸕	xbz
穋	wni
濾	oxn
鏕	tal
鯥	zaa
鵱	atz
鷜	juz
屢	njg
垏	axv
鑢	txn
奱	iyk
鸞	iyz
擽	hns
掄	hgy
鑼	tcr
臝	pjs
溤	orm
顢	uzt
蟎	cuk
堥	cla
腜	vys
痗	utn
媔	gtm
喕	jtm
麫	skw
媌	gbb
錉	tyd
詺	ixj
眿	fzi
嗼	jlm
恈	nof
鴾	ofz
枏	sgt
碙	uge
巎	etl
娞	gag
儞	mth
隬	fth
踂	efw
櫱	jas
餪	whk
掿	hbu
糑	dif
坢	ash
龎	wee
阫	fjb
稝	wvv
樥	sbq
髼	ilq
剻	evp
悂	nxa
鵧	scz
銢	tti
囨	gjb
楄	szy
淜	ovv
迉	nod
魌	goo
斉	cnt
蚔	cyv
愭	nad
簱	kyo
呇	ijk
唭	joq
薺	bpt
礘	udx
冾	fgh
竏	kxq
騝	rxo
鰬	zxc
篏	kyn
廧	xad
撽	hnl
躈	enl
鳹	rwz
鑋	pet
筁	kyq
螶	aac
硞	ufj
嘫	jvx
繎	yvx
儴	myw
嬈	gal
鵀	mvz
肕	vpz
靭	zpz
軵	pmu
桇	gjs
鄏	zuf
輭	phk
捼	hwg
濏	ova
鬙	ivd
挱	hoa
翜	nkk
蔪	bpl
饍	wij
娋	gdv
堔	acs
鵿	zdb
鸤	nzn
葹	byd
蒔	bdw
榯	sdw
諟	idh
咰	jfd
尌	puc
竪	erk
鬊	iqd
埣	apu
煫	xsr
襚	lso
繸	yso
槂	suy
鶽	ruz
咜	jlw
蹹	egn
誻	iid
嚃	jco
坣	dat
啺	jbi
蜪	cfb
籘	kvy
鷏	ntz
岧	ema
侹	mvo
妵	gzv
鋵	twb
腯	vwf
鶟	rpz
鷒	tcz
涒	ooj
魠	zav
駄	rkz
楕	suv
湋	ohw
溈	ozx
蜲	cwg
叞	nlr
硙	uea
媦	gbv
砇	ucw
莬	bzk
萵	bdj
踒	ewg
腛	vng
瞃	fwf
歍	znq
屗	neu
琋	qhz
槢	snn
謵	inn
纚	yea
餼	wtd
僲	mua
廯	xzi
伭	mpy
憪	nev
醎	zim
烍	xfk
娨	gdk
鯗	smz
簘	kxd
蟏	cbt
傚	mfl
燲	xit
阠	fwu
箵	khf
恟	nfg
髤	ism
珛	vuv
壻	ahv
蜁	cth
嫙	gyh
楥	sar
繏	yot
狘	piu
桪	sou
燖	xou
璕	qou
沇	ook
匽	adg
甗	xum
爓	xey
倄	mhv
嗂	jab
眑	fyi
鵺	pmz
杝	sdy
袘	ltd
鸃	ziq
鳦	zwi
螘	cea
檥	siq
詍	iuw
鹝	uzn
圛	gci
艗	lsc
囈	jbt
鷧	faz
垔	uat
溵	owt
唫	jtj
崟	etj
櫽	fas
孆	gfg
纓	yfg
盁	vcm
颕	wlt
悀	noe
踴	eoi
峟	euv
酑	zeu
魣	zcv
覦	gvk
鸆	xjz
鄅	ajf
蘛	bov
鸒	yez
籲	kgt
駌	xcr
鼘	puy
蒀	bdc
縕	ygc
帀	ezj
弉	yab
瞔	fqt
鸅	caz
鰂	zfp
熷	xvd
皻	xkz
鉙	tjt
鉊	tma
矺	uav
粍	dem
銸	tfw
讁	iko
獉	pqw
蜄	czc
佂	mbe
徔	kbb
墌	axx
幟	zsq
櫫	ras
竚	klr
諯	ieh
蠿	yyc
禌	lsy
胏	vqk
朡	vhl
翪	nhl
縂	yvn
劗	fkp
鷷	zuz
袏	lue
厑	wjw
伌	mwc
壒	abc
嬡	gil
懓	nil
痷	uku
誝	irj
韽	rws
隌	fsy
襖	lsk
玐	qtb
壩	arv
欛	srv
姅	gsh
幚	qfz
袌	yfo
髱	ifo
喺	jmy
昁	dnc
軰	ywp
捹	hkb
鎞	tsx
佊	mzp
胇	vin
湢	omb
熚	xbh
獘	wlp
炞	xph
襒	lwl
窉	rer
棅	swo
垪	asc
僠	mib
襏	ltt
犦	fdi
蚾	czp
轐	pnz
踄	ejh
螥	crj
膥	pik
臿	xyj
偛	mxy
艖	lie
獑	ppl
毚	zxz
鄽	xmf
壥	awa
剗	qqp
繟	ydu
仯	mha
唓	jpc
趂	dqh
爯	aga
徎	kjv
彨	evi
肔	vdy
翤	jyn
饎	wpj
揰	hxm
偢	mwx
殠	xdp
圌	geh
猭	por
荈	bxa
萅	bed
暙	dqd
瑃	vqd
箺	kqd
櫄	sxs
陙	fzc
偆	mqd
佌	mjw
皉	njw
徖	kll
欑	sft
磪	uer
翆	nmu
軚	pkz
饏	wfw
讜	ids
碭	ubi
闣	edb
屶	epd
翢	gqn
衜	psd
燾	awx
揼	hui
埞	alh
唙	jpx
俤	msq
埊	eia
摕	hbz
傎	mnt
扚	hfz
畳	bck
椗	slh
鯟	zpe
諌	ipe
霘	rom
吺	jts
阧	fld
酘	zts
斣	cfl
醏	zae
殬	xci
踲	ewf
挅	hvs
桗	svs
跥	evs
砈	uwc
阸	fzw
呝	jzw
遻	dso
奀	jkd
洏	ohe
瞂	wur
罸	ciu
琺	qoo
嬏	gib
颿	rbc
払	hos
裶	lpf
昲	din
廃	xtk
蒶	byp
豶	rut
琒	qlq
浲	olq
坲	ain
懯	tyn
葍	bmb
踾	emb
俌	mtf
捬	hxu
盙	tcm
猤	ptm
侅	mph
峼	efj
呄	vxg
佮	mgh
愅	nzg
鹒	xoz
緪	yne
峺	epg
堩	ane
杛	sig
龏	eeb
龔	eet
耈	aws
蚼	csj
茩	bwm
絓	yvg
叏	ary
罆	bnt
銧	tdl
窐	rvg
嬀	gax
陒	fqc
攱	kur
墎	acf
咍	joj
酼	ztg
嚡	jzv
肣	vrw
琀	vrj
蚢	cpb
籺	dtw
魺	zxk
靎	rtz
靏	rcz
拫	hmg
叿	jeg
鍧	tfi
霟	rot
黌	yhg
鍭	tmv
匢	afi
曶	fid
匫	afd
螜	fec
綔	key
嫮	gre
蔰	bzo
杹	smw
恵	ubn
嘒	jqo
檜	sgd
篲	kqo
闠	ect
睧	fyd
剨	qup
銈	tvg
嘰	jyk
隮	fpt
鐖	tyk
鑙	twd
忣	nrj
觙	qrj
焏	tjx
趌	dqj
銡	tqj
嶯	ejq
鱾	zaj
懻	nyt
泇	oij
蛺	ckk
徦	knr
惤	niy
豜	rck
殱	xue
襉	lev
鹼	ldk
螿	yvc
槳	yvs
嶕	erx
撟	hmj
卪	czd
嵥	exs
漌	ozt
僸	mcl
覲	ztk
舏	fcj
狊	fpq
蘜	bzd
昛	daa
懅	nxr
憰	ncj
欔	sfr
蚐	cff
碅	ugw
麏	aoj
燇	xzu
愾	ntd
歁	own
嶱	ebp
劥	pbi
窛	rtg
軭	pav
懬	xun
穬	wxg
巋	eaz
戣	tmq
頍	urt
尯	dqc
嬇	gct
蜫	cdx
萿	bof
鯻	zpp
棶	ssk
灡	obs
壏	aec
爤	xbs
灠	oek
粩	daw
嶗	exi
蛯	caw
軂	gxi
脷	vwp
驪	rea
蛠	cii
鉝	tkl
巁	ewr
礪	uwr
奩	kad
覝	kxk
濓	okn
嬚	gxn
裲	lek
煷	xcb
屪	nlh
豂	cni
爎	xlh
劽	xpi
猟	pys
暽	dda
翷	dxn
壣	afb
疄	bda
刢	rpd
砱	url
紷	yrl
欞	srk
驑	reb
嶐	efn
矑	fxc
籚	kxc
髗	dxc
騼	ral
曫	iyd
腡	vdj
覶	aok
笿	kog
霢	rvy
壾	paa
毜	ehx
愗	cln
唜	pjw
珻	qtn
槑	jss
攟	haw
跊	epw
懜	nbx
冞	cdm
麛	aif
爢	xcx
羋	bch
孊	gxp
宻	lre
婂	gnz
偭	mtm
庿	xbb
盿	fcw
慏	ncf
嚩	jyu
枺	spm
砞	upm
袹	lub
藦	bxh
礳	uxu
洠	oof
氁	elm
畒	pbk
胟	vnm
萺	bdf
乸	dnm
雫	reh
詉	igr
嫐	gbg
鯘	zwg
屔	lew
蚭	cnw
鉨	tqh
胒	vnw
嫟	gau
蹨	evx
惗	nrn
嵲	eds
拰	hmv
瘧	uxo
鷗	ajz
漚	oad
皅	nob
舥	lob
掱	hhh
鎃	toy
沗	mis
軯	pks
竼	kbz
槰	slo
憉	npi
鬔	ilo
喸	tjw
錍	tgu
阰	fxb
渒	ogu
彯	uli
翲	uln
撆	wlh
竮	knc
蚲	cks
幈	znc
蛢	csc
凴	frb
醱	ztt
尀	aju
岶	enb
洦	oub
兺	tpw
倛	moq
軝	pyv
粸	doq
蠐	cpt
愘	nlo
圲	axq
汘	oxq
鈆	tto
攐	hly
鬝	ied
橬	scd
猐	piw
嗴	jio
墝	aal
繑	ymj
嘺	jmj
琹	vvs
睘	cmy
藭	bri
趥	dzq
紌	ydy
釚	tmj
絿	yiq
浀	oyq
敺	ajx
葋	bvs
竬	kar
峑	ekv
埆	aqj
趞	dud
躟	eyw
譲	ify
囸	gbe
傇	mbf
媃	gcs
蝚	ccs
偄	mhk
腝	vhk
摋	hht
馺	rrj
矂	fjs
澁	ojj
圸	aes
烻	xao
嘇	joi
鐥	tij
漡	oti
恦	nsj
姺	gfk
峷	efx
鯓	zgs
浉	opz
釃	zea
笶	kvs
鉂	tjh
忕	nkd
呩	jls
籂	kwz
襫	lku
夀	twu
瑹	qbw
荗	biz
鑠	tns
銯	tys
価	mux
梩	sml
蕼	bix
儩	mfi
柗	stj
蜙	cso
駷	rps
廀	xlr
粛	xnd
縤	yqy
橚	sxy
滖	oyt
鞖	zag
砕	umu
脺	vpu
搎	huy
趖	dka
琑	qdv
鎻	tgt
狧	pfs
濌	xmd
粏	dkz
潬	odu
磄	uxj
篖	kxj
瑫	qay
迯	xho
鞀	zma
珶	qsq
惿	ndh
趧	ddh
鴺	kiz
挮	hsq
揥	hkz
婖	gmh
甛	yfs
窴	rnt
錪	tyt
樤	sms
晍	dgm
浵	ogi
秱	wgm
斢	ugl
峹	kwe
瘏	uae
跿	edo
莵	bsz
駾	rvk
拕	hlw
侻	mvk
捝	hvk
彵	kdy
萚	bhh
啘	jlc
韈	zbz
捖	hlk
綩	ylc
杤	sep
揻	hig
喡	jhw
癓	ukb
愇	nhw
骪	dbz
緭	ybv
餧	wwg
蘶	bwo
昷	dcm
珳	qci
脗	vfj
妏	gcw
脕	vzk
蝸	cdj
楃	sng
鎢	tzn
璑	qcu
俉	mvj
甒	cmw
岉	efi
矹	ulu
蘁	bvd
卥	liz
漝	onn
飁	nnc
欯	qnq
釳	ttw
硤	ukk
筪	kag
圷	aeh
鶱	lwz
鱻	zzz
蛝	cmg
顕	dnt
絤	yux
撊	hev
萫	bwd
襐	lzx
鐌	tzx
蟂	czs
簫	kxy
鷍	dsz
暁	dul
皢	nal
熁	xiv
擕	hrg
焎	hlx
塂	auo
緈	yai
忷	nhg
滫	omv
璓	qbv
揟	hhv
蝑	chv
訹	isz
鱮	zyt
琁	qth
暶	dyh
颴	bah
燂	xuu
卂	wus
侚	mfd
狥	pfd
狿	pao
楌	ski
黬	sim
醼	zux
饜	wdw
氜	tdr
坱	agk
葽	bug
媱	gab
曄	dbh
擖	hbp
擫	hwp
瑿	avl
瓵	ojm
伿	mjt
劮	ami
呹	jam
俋	mjo
唈	jjo
豙	krs
靾	zuw
嬟	giq
瞖	avf
褹	laz
冘	cke
泿	omg
蔩	blg
珱	qdg
愥	nbk
绬	ybk
噟	xmj
塋	xxa
櫿	sxj
嗈	jgo
廱	xgr
彮	lci
怣	amn
偤	mzq
湵	oiz
蜏	cwv
牰	fgy
亴	cam
釪	teu
艅	lkw
蕍	bop
噳	jxm
嶎	enu
銉	txv
礇	usk
驈	rcj
龥	gdt
熅	xgc
蝹	cdc
喗	jcp
馻	rok
醞	zgc
睵	fuj
傤	mup
傮	myd
璅	qgs
煰	xjd
皟	nqt
簀	kqt
謮	iqt
鍘	tfp
灹	xav
薝	bqi
蔁	bsu
瑵	qrc
旐	ytf
謺	aii
紾	yki
鎭	twt
恉	nwd
洔	ows
俧	man
觗	qyv
貭	wut
覟	ank
躓	elt
伀	mto
彸	kto
炂	xto
珘	qlo
婤	ggq
粙	dgy
劯	uil
絑	yap
瀦	ora
劚	nip
钃	tnc
鉒	tzv
鄟	tcf
蟤	cot
竱	ktu
庒	xaz
甀	xbm
硾	uxt
礈	uso
訰	iej
彴	kfz
葘	bub
釨	tui
騣	rhl
蓗	bkd
菆	bfr
稡	wpu
箤	kpu
絊	yse
㑇	mqo
㕮	jth
㘎	jel
㙍	arr
㛚	goe
㛹	gmp
㟃	ewm
㠓	eyr
㤘	nqo
㬎	dyx
㭎	sgh
㮾	zms
㴔	oqn
㸌	xrr
䁖	fdg
䅟	woi
䏝	vtz
䏡	vls
䏲	vsq
䐃	vgw
䓛	bng
䓨	ybf
䓬	bhu
䗖	cyz
䗛	cmv
䗪	xuc
䗴	cko
䝙	pah
䢺	jgf
䣘	djf
䲠	zqd
䶮	zmt
丮	whs
丳	jjn
乊	asb
乥	asw
乬	aaw
乮	ywi
乼	ozw
亃	dxw
亄	faw
亇	qcs
亗	ete
亪	qzd
亰	pdh
仈	mtb
仜	meg
仢	mfz
仱	mrw
仾	meo
伜	mmu
伩	mcw
佄	myg
佅	mpw
佨	mfo
佲	mxj
佸	mfs
侀	mcp
侇	mki
侎	mdm
侕	mhe
侜	mlo
侞	mgj
侟	muu
侤	mae
侱	mjv
侳	mka
侸	mad
俒	mlk
俙	mhz
俰	mwj
俻	mlb
倀	mei
倗	mvv
倠	mru
倯	mso
倱	mdx
倲	mpe
倳	mmx
偀	mbk
偂	msp
偅	mxm
偔	mde
偗	mhf
偝	myv
偠	mug
偣	msy
偯	myj
偼	mhh
傁	myr
傂	mwb
傋	mwa
傠	miu
傼	muk
傽	msu
傿	mbx
僆	mpo
僈	mqm
僋	mrt
僌	mpl
僓	mct
僛	mon
儏	mxd
儕	mpt
儖	mec
儙	mco
儤	mdi
儷	mea
冔	dju
冧	ccl
冩	cyx
冹	fur
凙	fci
凧	bzj
刅	ptb
刉	twp
刔	akp
刣	ojp
剅	apd
剈	jvp
剦	kup
剹	nkp
剼	oop
剾	ajp
劅	cfp
劆	xsp
劌	jip
劕	llp
劶	wmi
劷	iil
勆	zmi
勪	mji
勫	ibi
勬	myi
勭	kmi
勮	xri
勼	fmj
匎	fku
匒	fbg
匓	fmt
匔	fgj
匛	aqz
匨	aya
匩	aja
匴	akb
匷	afr
卋	uun
卛	iyu
厒	wbf
厗	wfx
厛	wjl
厬	wdj
厯	wcn
厵	wnh
厼	ohx
叀	ubo
叅	ooh
叐	xry
叜	lxr
吘	jtu
呚	jlx
呥	jga
呬	jcs
咊	jwh
咞	jck
咟	jub
哠	jfj
哶	jbk
哾	jvk
唴	jiw
唹	jyf
唺	jyt
啎	tuj
啙	jwd
啨	jqv
啿	jow
嗋	jiv
嗸	qpj
嗿	jrt
嘃	jxe
嘋	jal
嘦	jtg
嘾	juu
噃	jib
噚	jou
噦	jjh
噵	sdj
嚌	jpt
嚑	jxs
嚛	jns
嚠	jyp
嚳	yhj
囇	jea
囏	umj
囙	gak
囻	gbm
圎	got
圔	gac
圕	gxd
圙	gtt
圡	azd
圢	ard
圫	aav
圴	afz
圵	ais
圿	akn
坁	ayv
坃	atk
坅	arw
坋	atp
坘	aeo
坙	ega
坴	ata
坹	arx
坾	alr
坿	amu
垊	abm
垎	aog
垗	akf
垘	amp
垙	adl
垨	alu
垳	apx
垶	afx
垾	adk
埁	aew
埄	alq
埅	fya
埌	azm
埖	abw
埥	aqv
埩	aqx
埪	are
堏	sya
堒	adx
堗	arp
堚	acp
堛	amb
堜	aps
堢	ams
堣	abr
堨	adp
堫	ahl
堶	auv
堹	axm
堼	vua
堾	aqd
塇	alb
塒	adw
塕	atn
塖	aww
塝	aky
塡	awt
塦	fpa
塪	aay
塯	ayb
塳	alo
塷	ald
塻	alm
墂	aul
墏	yva
墕	abx
墖	agb
墢	att
墧	amj
墸	aba
墹	aed
壉	axr
壋	adb
壐	tza
壜	adt
壝	aco
壢	awj
夃	vry
夌	atl
夒	tjl
夨	wkd
夵	khx
夶	kkd
奅	kym
奆	kaa
奊	vwk
奒	kph
奝	kgq
奟	kvv
奦	clk
奫	koy
奰	cck
妐	gto
妑	gob
妕	gro
妡	glj
妢	gtp
妦	gqf
妷	gam
妼	gna
妽	gds
姉	gnc
姏	gyg
姙	gmv
姛	ggm
姭	iig
姲	glg
姳	gxj
姼	gxx
姾	gkv
娂	gut
娢	grj
娷	gxt
娸	goq
娻	gpe
娾	gwv
婃	gll
婇	gic
婔	gpf
婛	gch
婝	glh
婟	ggx
婡	gsk
婣	gyy
婫	gdx
婮	gnx
婱	ipg
婹	gug
婽	gnr
媄	gik
媆	ghk
媇	gks
媈	gcp
媉	gng
媋	gqd
媍	gqt
媎	gae
媑	gxm
媤	gbn
媨	gzq
媯	gzx
媰	gfj
媴	gay
媷	gzu
媹	gyb
嫅	gie
嫎	gky
嫛	avg
嫢	mfg
嫤	gzt
嫨	guk
嫳	wlg
嫴	gxf
嫶	grx
嫷	gfv
嫸	gij
嬄	gfa
嬊	ujg
嬒	ggd
嬓	gnl
嬘	gso
嬫	gxs
嬭	gth
嬯	gqg
嬵	gyz
嬼	gyp
孞	unx
孠	wmu
孡	uoj
孧	yiu
孾	ufg
宐	lcf
宑	lwj
宒	lem
宔	lzv
宺	ljw
寈	lqv
寋	lwc
寚	lvb
寣	lyi
寪	lax
寭	ltn
尮	dvs
尰	dxm
尲	dsn
尵	dct
屒	nzc
屚	nrv
屫	nyj
屰	sjc
屵	ewc
屷	evn
屸	eeg
岓	elj
岟	egk
岦	ekl
岪	ein
岯	eje
岴	ele
岻	eyz
峂	elf
峍	exv
峔	eaw
峖	elg
峚	eka
峲	ewp
峳	eml
峸	eiw
崍	esk
崜	ext
崝	eqv
崢	eax
崥	egu
崰	egb
崲	env
崷	ezq
崻	ekw
嵀	esv
嵄	eik
嵅	eim
嵔	eby
嵭	eky
嵶	eif
嶁	ejg
嶉	ejr
嶊	ehr
嶏	ewa
嶑	ezx
嶘	esq
嶟	ezu
嶧	eci
嶨	yhe
嶵	ecp
巕	esg
巰	egg
帇	ozj
帍	zzj
帒	mqz
帣	mzj
帪	zzc
帵	zlc
幊	zet
幘	zqt
幧	zjs
幯	zkc
庂	xkr
庎	xkn
庡	xyi
庢	xgi
庰	xsc
廅	xac
廔	xjg
廫	xvi
弌	qei
弬	iac
弲	ijv
彂	niv
彇	ixy
彉	iug
徆	kux
徛	kkx
徝	kni
徫	khw
徱	kul
徲	knf
徾	kei
忀	kyw
忁	kdi
忊	nrd
忛	nbz
忯	nyv
怑	nsh
怓	ngr
怢	nam
怭	nna
怺	nzi
恄	nqj
恮	nkv
悐	pxn
悑	ntf
悓	nfk
悙	nct
悡	wpn
悿	nmh
惃	ndx
惈	nbs
惉	oln
惌	lxn
惍	ntj
惒	wjn
惞	nln
愂	fun
愃	nlb
愌	nqk
愙	lon
愢	nbn
愮	nab
愺	nbu
慂	oon
慜	tnn
慞	nsu
慠	nql
慦	iln
憄	knn
憈	nxn
憘	npj
憜	nfv
憳	nou
懀	ngd
懌	nci
懏	nrg
懕	wdn
懛	nqg
懡	nxo
懩	nim
懳	nqn
戃	nds
戙	gmq
戜	qjv
戧	rzq
戫	uvm
戭	leq
戵	ffq
戺	zos
扟	hwu
扴	hkn
扸	hyp
抁	hok
抌	hck
抎	hty
抙	hhs
抮	hki
抴	huw
拁	hij
拪	hux
挃	hgi
挋	hec
挬	hfu
挿	hxd
捀	hlq
捇	han
捗	hjh
捙	hpc
捛	hjj
捤	hne
捦	htj
掅	hqv
掆	hge
掋	hxz
掲	hdw
揂	hzq
揈	hfi
揊	hmb
揔	hfn
揦	hpp
揬	hrp
揱	dvh
搑	hbf
搚	hiv
搟	hpk
搣	hix
搩	hxs
搸	hqw
摉	hrx
摙	hpo
摫	hmk
摬	hsk
撉	cuh
撍	hcd
撎	hfa
撜	hta
撠	huq
撡	hoh
撪	hop
撱	hfv
擆	hba
擏	hbl
擜	hup
擶	hkp
擻	hjl
攁	him
攊	hwj
攎	hxc
攑	hyh
攭	hoc
敄	clx
敜	rwl
敡	dfx
敮	xyx
敾	isl
敿	mjl
斆	yhl
斍	cfk
斘	xld
斞	ykl
斴	dxl
旀	yoh
旍	ytr
旔	yxo
旟	ytt
旤	djc
昈	dzh
昑	drw
昗	dfl
晆	dvg
晜	dsq
晥	dlk
晭	dgq
暀	dkv
暃	dpf
暞	dds
暬	atd
暺	ddu
曊	dit
曋	duu
曟	ddz
曢	dlh
朁	ccd
朆	vdi
朑	vuw
朙	gtv
朚	pdv
朤	vvv
朷	spd
杅	seu
杊	sgc
杘	nsm
杚	stw
杧	spw
枂	svy
枖	smt
枡	sab
枦	szh
枾	sue
柇	swh
柌	swm
柡	sti
柧	sag
柨	suz
柾	sbe
栂	snm
栍	sns
栚	ssm
栠	mvs
栤	sfi
栭	she
栰	smq
栵	sxp
栺	swd
桏	sef
桒	ubs
桙	sof
桞	sxf
桬	ohs
桸	shz
桹	szm
梇	svb
梊	hls
梚	szk
梞	san
棑	spf
棖	sei
棛	stv
棞	sgw
棤	sud
棦	sqx
棴	svr
棾	ccb
椆	sgq
椔	sgb
椛	sbw
椦	smi
椶	shl
椾	ssp
楅	smb
楈	shv
楋	spp
楎	scp
楐	sbn
楑	stm
楳	sys
榒	sif
榵	sbf
榽	sak
槇	swt
槗	suj
槝	sze
樍	sqt
樒	sle
権	str
樴	ssq
橃	stt
橌	sev
橒	srt
橗	sbv
橠	syx
橲	spj
橳	svi
橴	sjy
橷	snk
檅	sjh
檆	sxl
檋	sup
檕	pgs
檙	sfy
檱	sko
檷	sth
檽	srh
櫀	soy
櫏	suo
櫒	sbl
櫘	sqn
櫢	sjl
櫣	sbo
櫤	skp
櫩	sey
櫪	swj
櫯	szw
欚	soc
欩	mnq
欰	acn
欳	hyn
歄	djn
歞	dyn
歨	jhf
歫	jaa
歾	xfi
殨	xct
殫	xdu
殶	zvt
殻	fbj
毇	ydt
毞	xem
毠	ije
毤	toe
毩	edm
毭	aem
毮	hhe
毲	rre
毴	epf
氥	tux
氻	oil
汏	okd
汣	oqz
沀	icv
沎	omw
沵	oqh
泍	ose
泤	owk
泦	onm
泭	omu
洡	ots
浌	omq
浗	oiq
浱	ozc
涄	oge
涆	odk
涋	olp
涚	ovk
淣	oyk
淭	ozs
渜	ohk
渷	opk
渽	ouj
湂	ode
湕	oxo
湞	oht
湠	oex
湭	ozq
湷	oqd
湼	oye
溂	opp
溣	omy
溾	ogo
滐	oxs
滧	ofl
滬	ozo
漜	oca
潌	org
潥	oud
潧	ovd
澃	iti
澏	oje
澔	onj
澮	ogd
澯	oxd
濜	oxc
濷	iok
濹	osa
瀅	oxl
瀐	oue
瀢	oco
灅	oba
灎	oyc
灙	ods
灨	ost
炃	tpx
炇	xlx
炋	xjb
炛	xmw
炢	xsz
炥	xin
炨	xlw
炩	xrl
炾	xjk
烄	xfh
烉	qgx
烐	xlo
烒	xqe
烚	xgh
烼	xrs
焈	zox
焋	yax
焑	xgs
焔	xqd
焳	xru
焵	xge
焸	ddx
焹	xgp
焺	xdb
焽	dvx
焾	xrn
煀	xng
煂	xzg
煍	xwx
煓	xeh
煗	xhk
煘	xim
煢	xxu
煣	xcs
煪	xzq
煿	xtu
熎	xab
熩	xzo
熭	qqx
熴	xex
燗	xev
燛	eex
燩	xnl
爅	xsa
爏	xwj
爑	xbx
爣	xds
爥	xnc
爴	gqa
牫	fqg
牬	fqk
牭	fcs
犆	fni
犚	nlf
犩	wgf
犪	fsl
犫	rif
犻	pnc
狆	pro
狏	ptd
狚	pbd
狛	pnb
狦	pgt
狫	paw
狵	pui
狾	phl
猀	poa
猅	ppf
猉	poq
猏	pzv
猔	pll
猚	pru
猠	pyt
猳	pnr
猽	pcf
獇	pio
獊	prj
獋	pdu
獓	pql
獙	pwl
獡	pyx
獤	pcl
獥	pnl
獫	pgk
獹	pxc
獺	ppt
玀	pcr
玂	pbl
玌	qwe
玔	qgc
玜	qto
玪	qrw
玬	qgp
玴	quw
玶	vks
珁	qmw
珄	qns
珎	qqh
珔	quu
珕	vii
珟	qbx
珤	qbf
珨	qgh
珬	qie
珯	qaw
珴	qhq
珸	vvj
琓	qlk
琕	qgu
琘	qyd
琠	qyt
琷	qiw
琽	qae
琾	qbn
琿	qcp
瑂	vnf
瑅	vdh
瑉	qbd
瑖	vht
瑻	qnt
璌	qlg
璍	qbh
璡	qro
璢	qeb
璣	qyk
璭	qco
璳	qat
璴	qch
璻	qnu
璼	qec
璽	tzl
瓁	qbr
瓋	qko
瓑	qwj
瓔	qfg
瓕	itl
瓥	arc
瓨	emw
瓭	ckm
瓹	jvm
瓻	hum
甂	zym
甉	som
甊	jum
甌	ajm
甔	qwm
甤	rns
甮	fie
甶	abt
畂	bqz
畕	bbt
疂	bfk
疌	xhf
疓	uvn
疛	uuc
疜	ueh
疧	uyv
痆	unw
痚	uau
痥	uvk
痬	udi
痮	uei
痸	ufp
痻	uyd
瘇	uxm
瘔	ubx
瘶	upn
癏	ucy
癙	uys
癛	upw
癦	usa
癧	uwj
癪	uwt
皌	npm
皒	nhq
皣	nbh
盀	hcm
盰	fkg
眧	fma
眳	fxj
睅	fdk
睋	fhq
睓	fyt
睤	fbl
睰	fbu
睴	fcp
睶	fqd
睻	flb
瞓	fig
瞙	flm
瞚	flg
瞦	fpj
瞨	fnz
瞸	fbs
矀	fkb
矁	fwn
矄	fxs
矤	ivs
矪	vlo
砋	uji
砏	utp
砙	umw
砛	urw
砤	utd
砨	uzw
砪	unm
硆	ugh
硉	uxv
硓	uaw
硔	uut
硢	ukw
硦	uvb
硯	ufk
硱	ugs
硴	ubw
硶	uew
碊	uqq
碒	utj
碤	ubk
碫	uht
碷	uwf
磶	uyx
磸	uzk
磿	wwu
礂	upj
礒	uiq
礛	uec
礯	uxy
礿	lfz
祑	lam
祦	ljm
祱	lvk
禉	lzq
禓	lbi
禶	lft
秊	wxq
秌	xwh
秎	wtp
秚	wsh
秛	wzp
秜	wnw
秝	wwh
秞	wgy
秠	wje
秲	wws
秹	wmv
秺	wlv
稇	wgs
稈	wdk
稏	wen
稒	wgx
稖	wkj
稘	woq
稤	wch
稥	wxd
稦	whw
稨	wzy
稩	wbv
稫	wmb
稵	wsy
穒	wzn
穕	wrs
穙	wnz
穚	wmj
穛	wrx
穤	wrh
穥	wyt
穪	wth
穮	wax
穻	reu
穾	rmt
窏	rou
窓	ron
窢	rqm
窤	rdx
窧	rhu
窱	rms
窷	rfy
窹	ryj
竧	kgs
竲	kvd
笂	kmz
笌	kay
笍	krn
笎	ktk
笐	kpb
笖	kwk
笗	klf
笚	kgj
笜	kjg
笧	kyc
笵	koc
笽	kcm
筕	kpx
筤	kzm
箄	kgu
箉	khi
箖	kcl
箟	kdx
箯	kmp
箰	kfu
箲	kok
箷	kyd
箼	kng
箽	kxm
箿	kjf
篊	kot
篎	kfa
篕	kac
篞	kom
篢	ket
篽	kkc
簎	khd
簓	kgi
簞	kdu
簣	kct
簥	kmj
簩	kxi
簵	kpo
籆	kbr
籈	kum
籉	kqg
籋	kth
籖	kue
籡	khk
籷	dav
籸	dwu
籾	dpz
粀	deh
粁	dxq
粊	xdm
粎	dnz
粨	dub
粭	dgh
粴	dml
粷	dfd
糂	dow
糄	dzy
糋	dsp
糔	drc
糚	dba
糡	dsk
糣	dcd
糩	dgd
糪	njd
糫	dcy
糳	nid
糴	kdr
糽	yrd
紑	yjb
紪	yjw
紭	yio
紸	yzv
絉	ysz
絖	ydl
絟	ykv
絠	yuv
絧	ygm
絭	mys
絼	ypi
絾	yiw
綂	ypk
綕	yan
綘	ylq
綛	ypn
綡	ych
綥	ybl
綧	ycu
緍	yyd
緕	yct
緢	ybb
緧	yzq
緸	yua
緿	yon
縀	ynr
縃	yhv
縅	yig
縇	ylb
縒	yie
縓	ywh
縔	yrs
縥	yqw
縪	ybh
縬	yih
縸	ylm
縼	yyh
繊	yun
繌	ysl
繍	yxd
繛	qyu
繠	nny
繧	yrt
繵	ypb
繺	yqx
纅	yns
纉	ymt
罁	bge
罤	csq
罺	cgs
罻	cnu
羀	ghb
羗	iwo
羘	viy
羻	ial
翓	qnv
翿	awn
耼	fgt
聅	fvs
聓	ebf
聢	flh
聤	fcr
聥	far
聮	fyx
肗	vgn
肙	jvy
肰	vpq
肳	vfi
肵	vlj
肹	vte
胅	vam
胑	vjt
胵	vgi
胷	fhv
胹	vhe
脀	wiv
脙	viq
脳	vdg
脴	vjj
脵	vjm
脼	vek
腖	vpe
腤	vsy
腲	vby
腷	vmb
膃	vgc
膌	vfv
膓	vti
膶	vev
膾	vgd
臈	vbp
臐	vxs
臔	vet
臖	ygv
臗	vlz
臡	umk
臩	een
臫	dwe
臮	dmk
臯	dfu
臱	dry
臵	gog
舃	yex
舽	lla
艂	llq
艆	lzm
艐	lhl
艒	ldf
艕	lky
艠	lta
艢	lad
艣	lxi
艤	liq
艥	ljq
艩	lpt
芁	bbj
芆	brz
芞	btq
苅	bhp
苨	bnw
苮	bme
苰	bio
苵	bam
茒	bxf
茙	bqu
茣	bjm
茮	bih
荁	beb
荋	bhe
荎	bgi
荝	bqp
荰	bsa
荱	bne
荴	bhm
荹	bjh
荿	biw
莀	bzc
莌	bvk
莏	bha
莑	blq
莔	bgg
莝	bka
莥	bpa
莭	bmc
莿	bnp
菃	qaa
菐	niz
菚	bqq
菞	bwa
菬	bom
菳	btj
菶	bqh
菷	boz
菺	bzv
萟	bwz
萠	bvv
萢	boo
萴	bfp
萶	bqd
萾	bvc
葀	bhf
葐	btc
蒥	byb
蒰	blt
蓀	buy
蓈	bzf
蓛	bnl
蓜	bza
蓩	bci
蔙	byh
蔧	bqo
蕄	ben
蕕	bpz
蕛	bwq
蕟	btt
蕵	bxw
蕿	bxr
薗	bgz
薚	bxi
薽	bum
藄	boy
藊	bwy
藱	buo
藲	bsd
藵	bmy
蘃	bjs
蘰	byq
蘴	bea
蘵	bfq
蘻	bpy
虃	boe
虉	buz
虊	bis
虗	xle
虠	fhb
虥	xbq
虲	chb
虶	ceu
蚄	cyf
蚅	cwc
蚚	clj
蚛	cro
蚟	cvw
蚦	cgt
蚷	caa
蚽	cje
蛒	cog
蛕	cuv
蛚	cxp
蛨	cub
蛫	cqc
蛬	utc
蜌	cxa
蜟	ctv
蜠	cgw
蜯	cqh
蜰	voc
蜵	cyy
蜸	erc
蜽	cek
蝊	clh
蝒	ctm
蝖	clb
蝛	cig
蝝	cor
蝞	cnf
蝩	cxm
蝬	chl
蝳	cqn
蝵	wxc
螔	cwb
螕	csx
螙	scc
螧	cad
螪	ckj
螸	cnc
螹	cpl
螼	czt
蟈	cgm
蟍	cws
蟔	csh
蟖	col
蟘	cmt
蟚	pic
蟝	cos
蟰	cxy
蟵	cwu
蟶	cfv
蠄	ckr
蠉	ccy
蠌	cci
蠑	cxs
蠒	tzc
蠚	buc
蠦	cxc
蠩	cia
蠰	cyw
蠳	cfg
蠴	cba
衦	lkg
衴	lck
袀	lff
袕	lrx
袡	lga
袣	luw
袧	lsj
裃	lih
裄	lpx
裫	lyy
裷	lmc
裻	ihy
褈	lxm
褗	lag
褣	llc
襑	lou
襔	luk
襣	ldl
襷	lyh
襺	lbc
覄	ump
覉	uzx
覨	dek
覫	kyk
覾	lik
覿	ack
觃	eui
觪	qfx
觮	qoi
觲	qif
觵	qug
觶	qdu
觷	yhq
訋	ifz
訙	imz
訡	irw
訤	ihh
訦	ick
訬	iha
訲	iro
詀	ila
詊	ish
詚	ibd
詪	img
詶	idg
詸	idm
詻	iog
誈	igi
誛	ior
誟	iau
誫	izc
誮	ibw
誯	idd
誺	isk
諃	icl
諆	ioq
諈	ixt
諎	iud
諓	iqq
諚	ilh
諣	idj
諥	ixm
諨	imb
諪	icr
諬	wdi
諽	izg
謃	idn
謏	iyr
謕	iwb
謘	inf
謤	iul
謪	ikj
謰	ipo
謸	iql
謼	ixu
譅	ipj
譋	iev
譌	iax
譐	izu
譛	imd
譡	idb
譿	iqn
讆	phi
讏	pai
讒	izz
讝	idl
谉	ild
豏	asn
豑	yaq
豛	rts
豟	rzw
豣	rek
豧	rtf
豮	ruq
豱	rdc
貕	pak
賃	mvt
賝	fts
賡	xot
賧	ftx
贄	ait
赽	dak
赿	dyv
趏	dfs
趛	dtj
趭	drx
趲	dft
跇	euw
踻	edj
踿	ewx
蹃	ebu
躋	ept
躎	eth
躒	ens
軁	gjg
軅	gwr
軆	gya
軐	pwu
軕	pes
軗	pts
軘	pej
軞	pem
軡	prw
軧	pyz
軩	poj
軬	okp
軶	pzw
輋	ekp
輌	pne
輍	pcg
輖	pgq
輡	pqy
輣	pvv
輴	pwf
輷	pfi
輽	pob
轊	pqo
轋	ppo
轙	piq
轝	yep
轞	pec
迃	eeo
迣	uwo
迬	zvo
迱	lwo
迲	aoo
逜	vjo
逧	cod
逪	udo
逰	hto
逺	awo
遀	ueo
遌	deo
邍	lbo
邎	vio
邫	qjo
郒	zmo
郘	jjf
郬	qvf
鄇	maf
鄋	ycf
鄎	dnf
鄕	ynf
鄬	aaf
鄲	dbf
鄵	jdf
鄺	xuf
酀	ujf
酁	zxf
酦	zjr
酫	zkv
酳	zyv
醂	zcl
醾	zxd
釞	tkr
釮	tua
釱	tkd
釴	tqi
釶	tdy
釻	tmz
釾	tay
鈋	tmw
鈓	tvw
鈙	txd
鈪	twc
鈫	tcw
鈱	tbm
鈲	tag
鈶	toj
鈼	tra
鉃	tvs
鉇	ttd
鉡	tsh
鉧	tnm
鉪	tuw
鉯	twk
鉽	tqe
銁	tfd
銆	tub
銏	tyc
銐	xpt
銔	tju
銟	tez
銰	tbh
鋍	tfu
鋏	tkk
鋑	tol
鋕	tan
鋽	thu
鋾	tfb
錊	tpu
錔	tid
錖	iht
錗	twg
錤	toq
錥	ttv
錭	tgq
錵	tbw
鍄	tch
鍅	too
鍎	twf
鍏	thw
鍒	tcs
鍓	tjf
鍜	tnr
鍟	tdn
鍢	tmb
鍨	ttm
鍴	teh
鍹	tlb
鍻	tdp
鍽	tzy
鎀	tmi
鎆	tsp
鎍	tfy
鎑	tac
鎝	tbg
鎟	trs
鎠	tcb
鎣	xxt
鎷	trm
鏋	tuk
鏛	tdz
鏥	tlu
鏫	tws
鏬	txu
鏳	tvd
鏴	teo
鐀	tct
鐂	teb
鐆	fst
鐎	trx
鐑	tyq
鐞	tou
鐟	tmd
鐢	cht
鐫	trg
鐰	tjs
鑂	txs
鑆	tnu
鑈	tth
鑓	tco
鑝	tbo
鑦	tet
鑧	tlz
鑪	txc
鑳	tle
鑹	try
钀	txp
镽	ikh
閅	erd
閗	eld
閠	elv
閯	eoa
閺	edc
闗	eyx
闙	ezl
闚	emk
闦	eya
陎	fap
陦	fqu
陾	fhk
隁	fag
隉	fye
隫	fut
隭	frh
隯	fau
隲	fhr
隷	ali
隿	qru
雂	rwr
雤	yhr
雴	rkl
霋	rxg
霌	rgq
霐	roo
霒	rtw
霕	rtj
霛	rii
霣	rjt
霥	rcr
霯	rta
霴	rti
霵	rjq
霶	roy
霷	rdi
霺	rkb
霻	rya
霽	rpt
靀	ryr
靁	rbb
靅	rtt
靌	rlt
靔	qvt
靗	qvl
靫	zrz
靲	zrw
靻	zkq
鞝	zdj
鞸	zbh
鞻	zjg
鞼	zct
韉	zbx
韊	zbs
韚	hzg
韛	hue
韟	hnu
韯	uqe
韴	sez
頝	fht
頯	vbt
頺	wvt
顉	tty
顜	wgt
顪	jit
顳	fft
颪	ehc
颵	bav
飰	wph
飳	wzv
飹	wym
餀	wbh
餆	wkf
餏	wyi
餞	wqq
餣	wku
餤	wxx
餥	pws
餩	wkp
餫	wcp
餭	wnv
餯	wor
餴	wkb
餹	wxj
饂	wdc
饚	wbc
饝	wxu
饞	wzz
饠	wcr
馢	wdq
馰	rfz
馲	rav
馶	rur
馷	rnc
馸	rlj
馼	rcw
駅	rnz
駇	rlx
駈	rle
駋	rma
駍	rks
駎	rgy
駗	rki
駜	rna
駧	rgm
駨	rfd
駩	rkv
駯	rap
駳	rao
駶	rnj
駺	rzm
駽	rjv
騀	rhq
騚	rsp
騡	rni
騬	rww
騯	rky
騲	rbu
騳	rrm
騿	rsu
驆	rbh
驇	atr
驉	rxn
驓	rvd
驘	pjr
驙	rpb
驝	rfs
驠	rux
驣	rmr
骵	dse
骽	dag
髛	cnm
髵	ihe
髿	ioa
鬦	lld
鬬	lyl
魦	zha
魪	zkn
魬	zwr
魮	zxb
魰	zcw
魱	zeo
魲	zzh
魳	zez
魸	zyp
魾	zje
鮅	zna
鮇	zpw
鮏	zns
鮜	zwm
鮠	zqc
鮢	zap
鮱	zaw
鮼	zor
鮿	zfw
鯃	zvj
鯋	zoa
鯎	ziw
鯏	zwp
鯑	zhz
鯒	zoe
鯚	zwu
鯞	zoz
鯠	zsk
鯼	zhl
鰀	zar
鰄	zig
鰊	zps
鰑	zbi
鰕	znr
鰚	zlb
鰝	zcg
鰢	zrm
鰦	zsy
鰯	zif
鱃	zia
鱊	zcj
鱋	zxn
鱌	zzx
鱚	zpj
鱛	zvd
鱞	zcy
鱠	zgd
鱡	zfu
鱥	zjh
鱩	zrb
鱭	zpt
鱰	zca
鲿	zdt
鳚	znu
鴅	gpz
鴲	wdz
鵎	agz
鵳	zvz
鵼	rez
鶇	pez
鶈	xgz
鶎	llz
鶙	kzz
鶢	aez
鶰	jfz
鶲	toz
鶷	lqz
鷈	zwb
鷐	dzz
鷰	ujz
鷼	edz
鸗	eez
鹶	ldw
麁	qal
麎	azc
麡	apt
黈	ugv
鼀	ate
鼆	cde
鼏	cfy
鼳	yfp
鼼	dbc
齳	jkp
龓	uve
龗	rde
龣	gdi
鿕	zgp
𠅤	pbn
𣸣	ouq
𤩽	vup
𥔲	ude
𥖨	ujs
𥻗	dsb
𦒍	kmn
𦰡	bwf
𧿹	enm
𨚕	obf
𪨰	eyq
𪩘	eup
𫟦	pso
𫠊	rpy
𫭟	aah
𫭢	akw
𫮃	avu
𫵷	ewi
𬃊	swq
𬇕	oep
𬉼	xah
𬍤	vou
𬒔	ujv
𬒗	upe
𬣞	ile
𬣡	ieq
𬩽	ouf
𬬻	thn
𬭯	twl
𬭳	tpj
𬯀	fcn
