的	白勹丶
一	一一一
是	日
不	不丶
了	了丨
在	丨土
人	人丶
有	⺝
我	手戈
他	亻也
这	文辶
个	人丨丨
们	亻门
中	口丨丨
来	一米
上	上一
大	大丶
为	丶力丶
和	禾口
国	囗王丶
地	土也
到	至刂
以	人
说	讠丷儿
时	日寸
要	覀女
就	小尤
出	屮凵
会	人云
可	可一
也	也ㄋ
你	亻⺈小
对	又寸
生	生一
能	厶⺝匕
而	而丨
子	子一
那	㇆阝
得	彳旦寸
于	一
着	⺶目
下	一卜
自	自一
之	之丶
年	
过	寸辶
发	又丶
后	
作	亻乍
里	里一
用	用丨
道	䒑自辶
行	彳亍
所	戶斤
然	犬灬
家	宀豕
种	禾口丨
事	肀
成	戊ㄋ
方	方丿
多	夕夕
经	纟ス工
么	丿厶
去	土厶
法	氵土厶
学	⺍冖子
如	女口
都	耂日阝
同	冂
现	王见
当	⺌彐
没	氵殳
动	云力
面	面一
起	走己
看	龵目
定	宀疋
天	一大
分	八刀
还	不辶
进	井辶
好	女子
小	小丶
部	立口阝
其	
些	止匕二
主	丶王
样	木羊
理	王里
心	心丶
她	女也
本	木一一
前	䒑⺝刂
开	一廾
但	亻旦
因	因丶
只	口八
从	人人
想	木目心
实	宀⺀大
日	日一
军	冖车
者	耂日
意	音心
无	无ㄋ
力	力丿
它	宀匕
与	丂一一
长	长丶
把	扌巴
机	木几
十	十丨
民	民ㄋ
第	⺮𢎨
公	八厶
此	止匕
已	已ㄋ
工	工一
使	亻
情	忄龶⺝
明	日月
性	忄生
知	矢口
全	人王
三	三一
又	又丶
关	䒑大
点	卜口灬
正	一止
业	业一
外	夕卜
将	丬夕寸
两	𰀃人人
高	高一
间	门日
由	由一
问	门口
很	彳艮
最	日耳又
重	丿車一
并	䒑廾
物	牜勹
手	手丨
应	广⺍一
战	卜口戈
向	口
头	⺀大
文	文丶
体	亻木一
政	一止攵
美	⺷大
相	木目
见	见ㄋ
被	衤皮
利	禾刂
什	亻十
二	二一
等	⺮土寸
产	厂
或	戈口一
新	立木斤
己	己ㄋ
制	牛冂刂
身	身丿
果	日木
加	力口
西	西一
斯	斤
月	月一
话	讠舌
合	亼口
回	囗口
特	牜土寸
代	亻弋
内	冂人
信	亻言
表	龶
化	亻
老	耂匕
给	纟亼口
世	廿㇗ㄋ
位	亻立
次	冫欠
度	广廿又
门	门ㄋ
任	亻壬
常	巾
先	⺧儿
海	氵母
通	龴辶
教	耂子攵
儿	儿ㄋ
原	厂白小
东	小
声	士
提	扌日
立	立一
及	乃丶丶
比	匕匕
员	口贝
解	⺈用牛
水	水丶
名	夕口
真	十
论	讠人匕
处	夂卜
走	走丶
义	丶乂
各	夂口
入	入丶
几	几ㄋ
口	口一
认	讠人
条	夂木
平	干丷
系	丿糸
气	气ㄋ
题	日页
活	氵舌
尔	⺈小
更	一日
别	口力刂
打	扌丁
女	女一
变	亦又
四	四一
神	礻申
总	丷口心
何	亻可
电	日乚ㄋ
数	米女攵
安	宀女
少	小丿丿
报	扌卩又
才	丿丿
结	纟士口
反	⺁又
受	又
目	目一
太	大丶丶
量	旦里
再	一冉
感	戊心
建	聿廴
务	夂力
做	亻古攵
接	扌立女
必	心丿丿
场	土ㄋ
件	亻牛
计	讠十
管	⺮宀㠯
期	月
市	亠巾
直	十一
德	彳十心
资	冫欠贝
命	亼口卩
山	山丨
金	金一
指	扌匕日
克	古儿
许	讠十
统	纟儿
区	匸㐅
保	亻口木
至	至一
队	阝人
形	一廾彡
社	礻土
便	亻一
空	穴工
决	冫人
治	氵厶口
展	尸龷
马	马一
科	禾⺀十
司	
五	五一
基	土
眼	目艮
书	丶
非	非一
则	贝刂
听	口斤
白	白一
却	土厶卩
界	田人
达	大辶
光	⺌兀
放	方攵
强	弓口虫
即	卩
像	亻象
且	且一
难	又隹
权	木又
思	田心
王	王一
象	象丶
完	宀一兀
设	讠殳
式	弋工
色	⺈巴
路	⻊夂口
记	讠己
南	十冂
品	口吅
住	亻丶王
告	⺧口
类	米大
求	一氺丶
据	扌尸古
程	禾口王
北	匕
边	力辶
死	歹匕
张	弓长
该	讠亥
交	六乂
规	夫见
万	一
取	耳又
拉	扌立
格	木夂口
望	亡月王
觉	⺍冖见
术	木丶丶
领	亽龴页
共	龷八
确	石⺈用
传	亻二丶
师	リ一巾
观	又见
清	氵龶⺝
今	亽㇆ㄋ
切	七刀
院	阝宀兀
让	讠上
识	讠口八
候	矢
带	冖巾
导	巳寸
争	⺈
运	云辶
笑	⺮丿大
飞	乙
风	⺇乂
步	止
改	己攵
收	丩攵
根	木艮
干	干丨
造	⺧口辶
言	言一
联	耳䒑大
持	扌土寸
组	纟且
每	母
济	氵文
车	车丨
亲	立木
极	木乃丶
林	木木
服	月卩又
快	忄人
办	力八
议	讠丶乂
往	彳丶王
元	一兀
英	艹大
士	士一
证	讠一止
近	斤辶
失	丿夫
转	二丶
夫	夫丶
令	亽龴
准	冫隹
布	巾
始	女厶口
怎	乍心
呢	口尸匕
存	丨子
未	未丶
远	一兀辶
叫	口丩
台	厶口
单	丷日十
影	日彡
具	
罗	罒夕
字	宀子
爱	又
击	凵
流	氵
备	夂田
兵	
连	车辶
调	讠⺆口
深	氵冖木
商	冂口
算	⺮目廾
质	⺁十贝
团	囗丿
集	隹木
百	丆日
需	⻗而
价	亻人
花	艹亻
党	儿
华	亻十
城	土戊㇆
石	石一
级	纟乃丶
整	束攵止
府	广亻寸
离	文凵厶
况	冫口儿
亚	一业
请	讠龶⺝
技	扌十又
际	阝示
约	纟勹丶
示	示丶
复	日夊
病	疒𰀃人
息	自心
究	穴九
线	纟戋
似	亻人
官	宀㠯
火	火丶
断	米㇗斤
精	米龶⺝
满	氵艹人
支	十又
视	礻见
消	氵⺌⺝
越	走戉
器	吅犬吅
容	宀谷
照	日刀灬
须	彡页
九	九ㄋ
增	土曰
研	石一廾
写	冖丂一
称	禾⺈小
企	人止
八	八丶
功	工力
吗	口马
包	勹巳
片	片ㄋ
史	口
委	禾女
乎	丿丷
查	木旦
轻	ス工
易	日勹
早	日十
曾	曰
除	阝亼朩
农	冖
找	扌戈
装	丬士衣
广	广丿
显	日业
吧	口巴
阿	阝可
李	木子
标	木示
谈	讠火火
吃	口乙
图	囗夂⺀
念	亽㇆心
六	六丶
引	弓丨丨
历	厂力
首	䒑自
医	匸矢
局	尸㇆口
突	穴犬
专	二㇉丶
费	弓贝
号	口丂
尽	尸㇏⺀
另	口力
周	⺆土口
较	六乂
注	氵丶王
语	讠五口
仅	亻又
考	耂丂
落	艹氵口
青	龶⺝
随	阝辶
选	⺧儿辶
列	歹刂
武	一弋止
红	纟工
响	口口
虽	口虫
推	扌隹
势	扌丸力
参	厶大彡
希	㐅巾
古	古一
众	人人人
构	木勹厶
房	户方
半	丷
节	艹卩
土	土一
投	扌殳
某	甘木
案	宀女木
黑	黑丶
维	纟隹
革	革丨
划	戈刂
敌	舌攵
致	至攵
陈	阝小
律	彳聿
足	足丶
态	大丶心
护	扌户
七	七ㄋ
兴	⺍
派	氵⺁
孩	子亥
验	马亼一
责	龶贝
营	口口
星	日生
够	句夕夕
章	音十
音	音一
跟	⻊艮
志	士心
底	广丶
站	立卜口
严	一业丿
巴	巴ㄋ
例	亻歹刂
防	阝方
族	方矢
供	亻龷八
效	六乂攵
续	纟十大
施	方也
留	田
讲	讠井
型	一廾土
料	米⺀十
终	纟夂⺀
答	⺮亼口
紧	〢又糸
黄	龷由八
绝	纟⺈巴
奇	大可
察	宀示
母	母丶
京	小
段	殳
依	亻衣
批	扌匕匕
群	彐丿羊
项	工页
故	古攵
按	扌宀女
河	氵可
米	米丶
围	囗韦
江	氵工
织	纟口八
害	宀丰口
斗	⺀十
双	又又
境	土音儿
客	宀夂口
纪	纟己
采	爫木
举	⺍
杀	㐅朩
攻	工攵
父	八乂
苏	艹力八
密	宀心山
低	亻丶
朝	十日月
友	又
诉	讠斤丶
止	止一
愿	厂白心
细	纟田
千	千丨
值	亻十一
仍	亻乃
男	田力
钱	钅戋
破	石皮
网	冂乂乂
热	扌丸灬
助	且力
倒	亻至刂
育	⺝
属	尸丿冂
坐	人人土
帝	巾
限	阝艮
船	舟几口
脸	月亼一
职	耳口八
速	束辶
刻	亥刂
乐	小
否	不口
刚	冂㐅刂
威	戊一女
毛	毛ㄋ
状	丬犬
率	亠幺十
甚	㇗
独	犭虫
球	王一丶
般	舟殳
普	䒑业日
怕	忄白
弹	弓丷十
校	木六乂
苦	艹古
创	人㔾刂
假	亻又
久	㇏㇏
错	钅龷日
承	乛水三
印	一卩
晚	日
兰	䒑二
试	讠弋工
股	月殳
拿	亼口手
脑	月文凵
预	予页
谁	讠隹
益	䒑八皿
阳	阝日
若	艹口
哪	口㇆阝
微	几
尼	尸匕
继	纟米㇗
送	䒑大辶
急	⺈彐心
血	丿皿
惊	忄小
伤	亻力
素	龶糸
药	艹纟丶
适	舌辶
波	氵皮
夜	亠亻
省	小丿目
初	衤刀
喜	壴口
卫	一一
源	氵厂小
食	食丶
险	阝亼一
待	彳土寸
述	木丶辶
陆	阝凵
习	习一
置	罒十一
居	尸古
劳	力
财	贝丿
环	王不
排	扌非
福	礻田
纳	纟冂人
欢	又欠
雷	⻗田
警	艹句言
获	艹犭犬
模	木䒤大
充	儿
负	⺈贝
云	云丶
停	亻丁
木	木丶
游	氵方子
龙	龙丶
树	木又寸
疑	匕矢疋
层	尸云
冷	冫亽龴
洲	氵⺍川
冲	冫口丨
射	身寸
略	田夂口
竟	音儿
范	艹氵㔾
句	句一
室	宀至
异	巳廾
激	氵白攵
汉	氵又
村	木寸
哈	口亼口
策	⺮木冂
演	氵宀八
简	⺮门日
卡	上卜
罪	罒非
判	丷刂
担	扌旦
州	⺍川
静	龶⺝
退	艮辶
既	旡
衣	衣丶
您	亻⺈心
宗	宀示
积	禾口八
余	亼朩
痛	疒龴
检	木亼一
差	⺶工
富	宀田
灵	彐火
协	十力八
角	⺈用
占	卜口
配	酉己
征	彳一止
修	夂彡
皮	皮丶
挥	扌冖车
胜	月生
降	阝夂㐄
阶	阝人
审	宀申
沉	氵冖几
坚	〢又土
善	羊䒑口
妈	女马
刘	文刂
读	讠十大
啊	口阝可
超	走刀口
免	
压	厂土丶
银	钅艮
买	乛⺀大
皇	白王
养	䒑夫
伊	亻彐丿
怀	忄不
执	扌丸
副	田刂
乱	舌乚ㄋ
抗	扌亠几
犯	犭㔾
追	丿㠯辶
帮	阝巾
宣	宀一旦
佛	亻弓
岁	山夕
航	舟亠几
优	亻尤
怪	忄又土
香	禾日
著	艹耂日
田	田一
铁	钅丿夫
控	扌穴工
税	禾丷儿
左	工
右	口
份	亻八刀
穿	穴牙
艺	艹乙ㄋ
背	匕⺝
阵	阝车
草	䒤十
脚	月土卩
概	木旡
恶	一业心
块	土人
顿	一页
敢	乛耳攵
守	宀寸
酒	氵酉
岛	山
托	扌丿七
央	大
户	户丿
烈	歹刂灬
洋	氵羊
哥	可可
索	糸
胡	古月
款	士示欠
靠	⺧口非
评	讠干丷
版	片⺁又
宝	宀王丶
座	广人土
释	丿米
景	日小
顾	厂页
弟	丷𢎨
登	癶豆
货	亻贝
互	一彑
付	亻寸
伯	亻白
慢	忄曰又
欧	匸㐅欠
换	扌⺈大
闻	门耳
危	⺈厂⺋
忙	忄亡
核	木亥
暗	日音
姐	女且
介	人
坏	土不
讨	讠寸
丽	一
良	丶艮
序	广予
升	丿廾
监	〢皿
临	〢
亮	几
露	⻗⻊口
永	丶
呼	口丿
味	口未
野	里予
架	力口木
域	土戈一
沙	氵小丿
掉	扌卜十
括	扌舌
舰	舟见
鱼	鱼一
杂	九木
误	讠口大
湾	氵亦弓
吉	士口
减	冫戊
编	纟户
楚	木木疋
肯	止⺝
测	氵贝刂
败	贝攵
屋	尸至
跑	⻊勹巳
梦	木木夕
散	龷⺝攵
温	氵日皿
困	囗木
剑	亼⺍刂
渐	氵斤
封	土土寸
救	一氺攵
贵	贝
枪	木人㔾
缺	缶人
楼	木米女
县	且厶
尚	尚一
毫	毛
移	禾夕夕
娘	女丶艮
朋	月月
画	一田凵
班	王王
智	矢口日
亦	亦丶
耳	耳一
恩	因心
短	矢豆
掌	手
恐	工几心
遗	贝辶
固	囗古
席	广廿巾
松	木八厶
秘	禾心丿
谢	讠身寸
鲁	鱼日
遇	禺辶
康	广彐水
虑	虍心
幸	土
均	土勹冫
销	钅⺌⺝
钟	钅口丨
诗	讠土寸
藏	艹臣
赶	走干
剧	尸古刂
票	覀示
损	扌口贝
忽	勹心
巨	匚コ
炮	火勹巳
旧	丨日
端	立山而
探	扌冖木
湖	氵古月
录	氺
叶	口十
春	日
乡	乡丿
附	阝亻寸
吸	口乃丶
予	予丨
礼	礻乚ㄋ
港	氵龷巳
雨	雨丶
呀	口牙
板	木⺁又
庭	广壬廴
妇	女彐
归	リ彐
睛	目龶⺝
饭	饣⺁又
额	宀夂页
含	亽㇆口
顺	川页
输	亼刂
摇	扌爫缶
招	扌刀口
婚	女日
脱	月丷儿
补	衤卜
谓	讠田⺝
督	上小目
毒	龶母
油	氵由
疗	疒了
旅	方
泽	氵又
材	木丿
灭	一火
逐	豕辶
莫	䒤大
笔	⺮毛
亡	亡ㄋ
鲜	鱼羊
词	讠
圣	又土
择	扌又
寻	彐寸
厂	厂丿
睡	目千二
博	十甫寸
勒	革力
烟	火因
授	扌又
诺	讠艹口
伦	亻人匕
岸	山厂干
奥	米大
唐	广肀口
卖	十乛大
俄	亻手戈
炸	火乍
载	十戈
洛	氵夂口
健	亻聿廴
堂	土
旁	方
宫	宀口口
喝	口曰亾
借	亻龷日
君	彐丿口
禁	木木示
阴	阝月
园	囗一兀
谋	讠甘木
宋	宀木
避	尸口辶
抓	扌爪
荣	木
姑	女古
孙	子小
逃	儿冫辶
牙	牙丿
束	束丶
跳	⻊儿
顶	丁页
玉	王丶丶
镇	钅十
雪	⻗彐
午	十
练	纟
迫	白辶
爷	八乂卩
篇	⺮户
肉	冂人人
嘴	口止用
馆	饣宀㠯
遍	户辶
凡	几丶丶
础	石屮凵
洞	氵冂
卷	
坦	土旦
牛	牛丨
纸	纟七
宁	宀丁
诸	讠耂日
训	讠川
私	禾厶
庄	广土
祖	礻且
丝	纟纟
翻	丿米羽
暴	日龷氺
森	木木木
塔	土艹口
默	黑犬
握	扌尸至
戏	又戈
隐	阝⺈心
熟	子灬
骨	骨一
访	讠方
弱	弓冫冫
蒙	一豕
歌	可可欠
店	广卜口
鬼	鬼丶
软	欠
典	
欲	谷欠
萨	艹阝厂
伙	亻火
遭	一曲辶
盘	舟皿
爸	八乂巴
扩	扌广
盖	⺷皿
弄	王廾
雄	厶隹
稳	禾⺈心
忘	亡心
亿	亻乙ㄋ
刺	木冂刂
拥	扌用
徒	彳走
姆	女母
杨	木ㄋ
齐	文
赛	𡨄贝
趣	走耳又
曲	曲一
刀	刀丿
床	广木
迎	卩辶
冰	冫水
虚	虍业
玩	王一兀
析	木斤
窗	穴一
醒	酉日生
妻	一肀女
透	禾乃辶
购	贝勹厶
替	夫夫曰
塞	𡨄土
努	女又力
休	亻木
虎	虎ㄋ
扬	扌ㄋ
途	亼朩辶
侵	亻彐又
刑	一廾刂
绿	纟氺
兄	口儿
迅	⺄十辶
套	大镸
贸	贝
毕	匕匕十
唯	口隹
谷	谷一
轮	车人匕
库	广车
迹	亦辶
尤	尤丶
竞	立口儿
街	彳土亍
促	亻足
延	丿止廴
震	⻗辰
弃	廾
甲	甲丨
伟	亻韦
麻	麻丶
川	川丨
申	申丨
缓	纟爫又
潜	氵夫曰
闪	门人
售	隹口
灯	火丁
针	钅十
哲	扌斤口
络	纟夂口
抵	扌丶
朱	丿未
埃	土厶矢
抱	扌勹巳
鼓	壴十又
植	木十一
纯	纟一
夏	丆目夂
忍	刀丶心
页	页丶
杰	木灬
筑	⺮工丶
折	扌斤
郑	䒑大阝
贝	贝丶
尊	丷酉寸
吴	口一大
秀	禾乃
混	氵日匕
臣	臣ㄋ
雅	牙隹
振	扌辰
染	氵九木
盛	戊㇆皿
怒	女又心
舞	卌㐄
圆	囗口贝
搞	扌高
狂	犭王
措	扌龷日
姓	女生
残	歹戋
秋	禾火
培	立口
迷	米辶
诚	讠戊㇆
宽	宀艹见
宇	宀一
猛	犭子皿
摆	扌罒厶
梅	木母
毁	臼工殳
伸	亻申
摩	麻手
盟	日月皿
末	一木
乃	乃丿
悲	非心
拍	扌白
丁	丁丨
赵	走㐅
硬	石一
麦	龶夂
蒋	艹丬寸
操	扌口木
耶	耳阝
阻	阝且
订	讠丁
彩	爫木彡
抽	扌由
赞	⺧儿贝
魔	麻鬼
纷	纟八刀
沿	氵几口
喊	口戊
违	韦辶
妹	女未
浪	氵丶艮
汇	氵匚
币	丿巾
丰	丰丨
蓝	艹〢皿
殊	歹丿未
献	十冂犬
桌	卜日木
啦	口扌立
瓦	瓦丶
莱	艹一米
援	扌爫又
译	讠又
夺	大寸
汽	氵气
烧	火兀
距	⻊匚コ
裁	十戈衣
偏	亻户
符	⺮亻寸
勇	龴力
触	⺈用虫
课	讠日木
敬	艹句攵
哭	吅犬
懂	忄艹一
墙	土十口
召	刀口
袭	龙衣
罚	罒讠刂
侠	亻一大
厅	厂丁
拜	龵一丰
巧	工丂
侧	亻贝刂
韩	十日韦
冒	⺜目
债	亻龶贝
曼	曰罒又
融	鬲虫
惯	忄毌贝
享	子
戴	十戈八
童	立里
犹	犭尤
乘	禾匕
挂	扌土土
奖	丬夕大
绍	纟刀口
厚	厂日子
纵	纟人人
障	阝音十
讯	讠⺄十
涉	氵止
彻	彳七刀
刊	干刂
丈	一
爆	火日氺
乌	乌一
役	彳殳
描	扌艹田
洗	氵⺧儿
玛	王马
患	口口心
妙	女小丿
镜	钅音儿
唱	口日曰
烦	火页
签	⺮亼一
仙	亻山
彼	彳皮
弗	弓
症	疒一止
仿	亻方
倾	亻匕页
牌	片十
陷	阝⺈臼
鸟	鸟一
轰	车又又
咱	口自
菜	艹爫木
闭	门丿
奋	大田
庆	广大
撤	扌攵
泪	氵目
茶	艹人木
疾	疒矢
缘	纟彑
播	扌丿田
朗	丶月
杜	木土
奶	女乃
季	禾子
丹	⺆亠
狗	犭句
尾	尸毛
仪	亻丶乂
偷	亻亼刂
奔	大十廾
珠	王丿未
虫	虫丶
驻	马丶王
孔	子乚ㄋ
宜	宀且
艾	艹乂
桥	木丿
淡	氵火火
翼	羽田八
恨	忄艮
繁	母糸
寒	𡨄⺀
伴	亻丷
叹	口又
旦	旦一
愈	亼⺝心
潮	氵十月
粮	米丶艮
缩	纟宀日
罢	罒土厶
聚	耳又
径	彳ス工
恰	忄亼口
挑	扌儿
袋	亻弋衣
灰	火
捕	扌甫
徐	彳亼朩
珍	王人彡
幕	䒤大巾
映	日大
裂	歹刂衣
泰	氺
隔	阝鬲
启	户口
尖	小大
忠	口丨心
累	田糸
炎	火火
暂	斤日
估	亻古
泛	氵丿之
荒	艹亡
偿	亻龸云
横	木龷八
拒	扌匚コ
瑞	王山而
忆	忄乙ㄋ
孤	子瓜
鼻	自田丌
闹	门亠巾
羊	羊丨
呆	口木
厉	厂一
衡	彳鱼亍
胞	月勹巳
零	⻗亽龴
穷	穴力
舍	亼古
码	石马
赫	土
婆	氵皮女
魂	云鬼
灾	宀火
洪	氵龷八
腿	月艮辶
胆	月旦
津	氵聿
俗	亻谷
辩	讠辛
胸	月勹凵
晓	日兀
劲	ス工力
贫	八刀贝
仁	亻二
偶	亻禺
辑	口耳
邦	阝
赖	束⺈贝
恢	忄火
圈	囗
摸	扌䒤大
仰	亻卩
润	氵门王
堆	土隹
碰	石䒑业
艇	舟壬廴
稍	禾⺌⺝
迟	尸丶辶
辆	车𰀃人
废	广丶
净	冫⺈
凶	㐅凵
署	罒耂日
壁	尸口土
御	彳卩
奉	
旋	方疋
冬	夂⺀
矿	石广
抬	扌厶口
蛋	疋虫
晨	日辰
伏	亻犬
吹	口欠
鸡	又鸟
倍	亻立口
糊	米古月
秦	禾
盾	⺁十目
杯	木不
租	禾且
骑	马大可
乏	丿之
隆	阝夂生
诊	讠人彡
奴	女又
摄	扌耳又
丧	十䒑
污	氵一丂
渡	氵广又
旗	方
甘	甘一
耐	而寸
凭	亻壬几
扎	扌乚ㄋ
抢	扌人㔾
绪	纟耂日
粗	米且
肩	户⺝
梁	氵刀木
幻	幺ㄋ
菲	艹非
皆	匕匕白
碎	石亠十
宙	宀由
叔	上小又
岩	山石
荡	艹氵
综	纟宀示
爬	爪巴
荷	艹亻可
悉	丿米心
蒂	艹巾
返	⺁又辶
井	井丨
壮	丬士
薄	艹氵寸
悄	忄⺌⺝
扫	扌彐
敏	母攵
碍	石旦寸
殖	歹十一
详	讠羊
迪	由辶
矛	予丿丿
霍	⻗隹
允	厶儿
幅	巾田
撒	扌龷攵
剩	禾刂
凯	山己几
颗	日木页
骂	吅马
赏	贝
液	氵亠
番	丿米田
箱	⺮木目
贴	贝卜口
漫	氵曰又
酸	酉厶夊
郎	丶阝
腰	月覀女
舒	亼古予
眉	目
忧	忄尤
浮	氵爫子
辛	辛丨
恋	亦心
餐	歺又食
吓	口一卜
挺	扌壬廴
励	厂一力
辞	舌辛
艘	舟臼又
键	钅聿廴
伍	亻五
峰	山夂丰
尺	尸㇏㇏
昨	日乍
黎	禾勹水
辈	非车
贯	毌贝
侦	亻卜贝
滑	氵骨
券	刀
崇	山宀示
扰	扌尤
宪	宀⺧儿
绕	纟兀
趋	走⺈彐
慈	䒑幺心
乔	丿大
阅	门丷儿
汗	氵干
枝	木十又
拖	扌也
墨	黑土
胁	月力八
插	扌千臼
箭	⺮䒑刂
腊	月龷日
泥	氵尸匕
粉	米八刀
氏	七
彭	壴彡
拔	扌丶
骗	马户
凤	几又
慧	丰丰心
媒	女甘木
佩	亻⺇巾
愤	忄十贝
扑	扌卜
龄	齿亽龴
驱	马匸㐅
惜	忄龷日
豪	豕
掩	扌大乚
兼	兼丶
跃	⻊丿大
尸	尸丿
肃	肀八
帕	巾白
驶	马口
堡	亻口土
届	尸由
欣	斤欠
惠	惠心
册	⺆⺆一
储	亻讠日
飘	覀示乂
桑	又又木
闲	门木
惨	忄厶彡
洁	氵士口
踪	⻊宀示
勃	子力
宾	宀
频	止页
仇	亻九
磨	麻石
递	丷𢎨辶
邪	牙阝
撞	扌立里
拟	扌人
滚	氵六
奏	一大
巡	巛辶
颜	厂页
剂	文刂
绩	纟龶贝
贡	工贝
疯	疒⺇乂
坡	土皮
瞧	目隹灬
截	十戈隹
燃	火灬
焦	隹灬
殿	尸龷殳
伪	亻丶丶
柳	木卯
锁	钅⺌贝
逼	田辶
颇	皮页
昏	七日
劝	又力
呈	口王
搜	扌臼又
勤	革二力
戒	戈廾
驾	力口马
漂	氵覀示
饮	饣欠
曹	一曲曰
朵	几木
仔	亻子
柔	予丿木
俩	亻𰀃人
孟	子皿
腐	广亻人
幼	幺力
践	⻊戋
籍	⺮耒日
牧	牜攵
凉	冫小
牲	牜生
佳	亻土土
娜	女㇆阝
浓	氵冖
芳	艹方
稿	禾高
竹	竹丨
腹	月夊
跌	⻊丿夫
逻	罒夕辶
垂	千艹二
遵	丷酉辶
脉	月丶
貌	豸白儿
柏	木白
狱	犭讠犬
猜	犭龶⺝
怜	忄亽龴
惑	戈口心
陶	阝勹缶
兽	丷田
帐	巾长
饰	饣巾
贷	亻弋贝
昌	日曰
叙	亼朩又
躺	身尚
钢	钅冂㐅
沟	氵勹厶
寄	宀大可
扶	扌夫
铺	钅甫
邓	又阝
寿	寸
惧	忄
询	讠勹日
汤	氵ㄋ
盗	冫欠皿
肥	月巴
尝	龸云
匆	勹丶
辉	小兀车
奈	大示
扣	扌口
廷	壬廴
澳	氵大
嘛	口麻
董	艹丿一
迁	千辶
凝	冫匕疋
慰	尸示心
厌	厂犬
脏	月广土
腾	月马
幽	山幺幺
怨	夕㔾心
鞋	革土土
丢	壬厶
埋	土里
泉	白水
涌	氵龴
辖	宀口
躲	身几木
晋	一业日
紫	止匕糸
艰	又艮
魏	禾女鬼
吾	五口
慌	忄艹
祝	礻口儿
邮	由阝
吐	口土
狠	犭艮
鉴	〢金
曰	曰一
械	木戈廾
咬	口六乂
邻	亽龴阝
赤	土
挤	扌文
弯	亦弓
椅	木大可
陪	阝立口
割	宀丰刂
揭	扌曰亾
韦	韦丨
悟	忄五口
聪	耳丷心
雾	⻗夂力
锋	钅夂丰
梯	木丷
猫	犭艹田
祥	礻羊
阔	门氵舌
誉	⺍言
筹	⺮寸
丛	人人一
牵	大冖牛
鸣	口鸟
沈	氵冖
阁	门夂口
穆	禾白彡
屈	尸屮凵
旨	匕日
袖	衤由
猎	犭龷日
臂	尸口⺝
蛇	虫宀匕
贺	力口贝
柱	木丶王
抛	扌九力
鼠	鼠ㄋ
瑟	王王丿
戈	戈丶
牢	宀牛
逊	子小辶
迈	一辶
欺	欠
吨	口一
琴	王王㇆
衰	亠口
瓶	䒑廾瓦
恼	忄文凵
燕	廿口灬
仲	亻口丨
诱	讠禾乃
狼	犭丶艮
池	氵也
疼	疒夂⺀
卢	卜尸
仗	亻一
冠	冖一寸
粒	米立
遥	爫缶辶
吕	口口
玄	亠幺
尘	小土
冯	冫马
抚	扌无
浅	氵戋
敦	子攵
纠	纟丩
钻	钅卜口
晶	日日日
岂	山己
峡	山一大
苍	艹人㔾
喷	口十贝
耗	耒毛
凌	冫土夊
敲	高攴
菌	艹囗禾
赔	贝立口
涂	氵亼朩
粹	米亠十
扁	户
亏	一丂
寂	宀上又
煤	火甘木
熊	厶⺝灬
恭	龷八⺗
湿	氵日业
循	彳⺁目
暖	日爫又
糖	米广口
赋	贝一止
抑	扌卩
秩	禾丿夫
帽	巾⺜目
哀	
宿	宀亻日
踏	⻊水日
烂	火䒑二
袁	土口
侯	亻矢
抖	扌⺀十
夹	一丷大
昆	日匕匕
肝	月干
擦	扌宀示
猪	犭耂日
炼	火
恒	忄一旦
慎	忄十
搬	扌舟殳
纽	纟丑
纹	纟文
玻	王皮
渔	氵鱼
磁	石䒑幺
铜	钅冂
齿	齿丨
跨	⻊大丂
押	扌甲
怖	忄巾
漠	氵䒤大
疲	疒皮
叛	丷又
遣	㠯辶
兹	䒑幺幺
祭	示
醉	酉亠十
拳	手
弥	弓⺈小
斜	亼朩十
档	木⺌彐
稀	禾㐅巾
捷	扌一龰
肤	月夫
疫	疒殳
肿	月口丨
豆	豆一
削	⺌⺝刂
岗	山冂㐅
晃	日小兀
吞	一大口
宏	宀厶
癌	疒口山
肚	月土
隶	彐水
履	尸彳夊
涨	氵弓长
耀	小兀隹
扭	扌丑
坛	土云
拨	扌丶
沃	氵丿大
绘	纟人云
伐	亻戈
堪	土㇗
仆	亻卜
郭	子阝
牺	牜西
歼	歹千
墓	䒤大土
雇	户隹
廉	广兼
契	丰刀大
拼	扌䒑廾
惩	彳一心
捉	扌足
覆	覀彳夊
刷	尸巾刂
劫	土厶力
嫌	女兼
瓜	瓜丶
歇	曰勹欠
雕	⺆土隹
闷	门心
乳	爫子乚
串	口口丨
娃	女土土
缴	纟白攵
唤	口⺈大
赢	赢贝
莲	艹车辶
霸	⻗革月
桃	木儿
妥	爫女
瘦	疒臼又
搭	扌艹口
赴	走卜
岳	一山
嘉	壴力口
舱	舟人㔾
俊	亻厶夊
址	土止
庞	广龙
耕	耒井
锐	钅丷儿
缝	纟夂辶
悔	忄母
邀	白方辶
玲	王亽龴
惟	忄隹
斥	斤丶丶
宅	宀丿七
添	氵一⺗
挖	扌穴乙
呵	口可
讼	讠八厶
氧	气羊
浩	氵⺧口
羽	羽一
斤	斤丨
酷	酉⺧口
掠	扌小
妖	女丿大
祸	礻口人
侍	亻土寸
乙	乙ㄋㄋ
妨	女方
贪	亽㇆贝
挣	扌⺈
汪	氵王
尿	尸水
莉	艹禾刂
悬	且厶心
唇	辰口
翰	十日羽
仓	人㔾
轨	九
枚	木攵
盐	土卜皿
览	〢见
傅	亻甫寸
帅	リ巾
庙	广由
芬	艹八刀
屏	尸䒑廾
寺	土寸
胖	月丷
璃	王文厶
愚	禺心
滴	氵古
疏	乛止
萧	艹肀八
姿	冫欠女
颤	亠囗页
丑	丑一
劣	小丿力
柯	木可
寸	寸丶
扔	扌乃
盯	目丁
辱	辰寸
匹	匸儿
俱	亻
辨	辛
饿	饣手戈
蜂	虫夂丰
哦	口手戈
腔	月穴工
郁	⺝阝
溃	氵贝
谨	讠革二
糟	米一曰
葛	䒤勹亾
苗	艹田
肠	月ㄋ
忌	己心
溜	氵田
鸿	氵工鸟
爵	爫罒寸
鹏	月月鸟
鹰	广亻鸟
笼	⺮龙
丘	一一
桂	木土土
滋	氵䒑幺
聊	耳卯
挡	扌彐
纲	纟冂㐅
肌	月几
茨	艹冫欠
壳	几
痕	疒艮
碗	石宀㔾
穴	穴丶
膀	月方
卓	卜日十
贤	〢又贝
卧	臣卜
膜	月䒤大
毅	豕殳
锦	钅白巾
欠	欠丶
哩	口里
函	乛氺凵
茫	艹氵亡
昂	日卩
薛	艹丿辛
皱	⺈彐皮
夸	大一丂
豫	予象
胃	田⺝
舌	舌一
剥	氺刂
傲	亻龶攵
拾	扌亼口
窝	穴口人
睁	目⺈
携	扌隹乃
陵	阝土夊
哼	口了
棉	木白巾
晴	日龶⺝
铃	钅亽龴
填	土十
饲	饣
渴	氵曰亾
吻	口勹
扮	扌八刀
逆	䒑辶
脆	月⺈⺋
喘	口山而
罩	罒卜十
卜	卜丶
炉	火户
柴	止匕木
愉	忄亼刂
绳	纟黾
胎	月厶口
蓄	艹亠田
眠	目民
竭	立曰亾
喂	口田
傻	亻夂
慕	䒤大⺗
浑	氵冖车
奸	女干
扇	户羽
柜	木匚コ
悦	忄丷儿
拦	扌䒑二
诞	讠丿廴
饱	饣勹巳
乾	十日乙
泡	氵勹巳
贼	贝戈
亭	丁
夕	夕丶
爹	八乂夕
酬	酉⺍川
儒	亻⻗而
姻	女因
卵	卵丶
氛	气八刀
泄	氵廿㇗
杆	木干
挨	扌厶矢
僧	亻曰
蜜	宀心虫
吟	口亽㇆
猩	犭日生
遂	丷豕辶
狭	犭一大
肖	⺌⺝
甜	舌甘
霞	⻗又
驳	马乂乂
裕	衤谷
顽	一兀页
於	方人⺀
摘	扌古
矮	矢禾女
秒	禾小丿
卿	丿卩
畜	亠幺田
咽	口因
披	扌皮
辅	甫
勾	勹厶
盆	八刀皿
疆	弓土一
赌	贝耂日
塑	䒑土
畏	田一
吵	口小丿
囊	吅
嗯	口因心
泊	氵白
肺	月一巾
骤	马耳
缠	纟广里
冈	冂㐅
羞	⺶丑
瞪	目癶豆
吊	口巾
贾	覀贝
漏	氵尸雨
斑	王文王
涛	氵寸
悠	攵心
鹿	鹿ㄋ
俘	亻爫子
锡	钅日
卑	十
葬	艹歹廾
铭	钅夕口
滩	氵又隹
嫁	女宀豕
催	亻山隹
璇	王方疋
翅	十又羽
盒	亼口皿
蛮	亦虫
矣	厶矢
潘	氵丿田
歧	止十又
赐	贝日
鲍	鱼勹巳
锅	钅口人
廊	广丶阝
拆	扌斤丶
灌	氵艹隹
勉	力
盲	亡目
宰	宀辛
佐	亻工
啥	口亼古
胀	月长
扯	扌止
禧	礻壴口
辽	了辶
抹	扌一木
筒	冂
棋	木
裤	衤广车
唉	口厶矢
朴	木卜
咐	口亻寸
孕	乃子
誓	扌斤言
喉	口亻矢
妄	亡女
拘	扌句
链	钅车辶
驰	马也
栏	木䒑二
逝	扌斤辶
窃	穴七刀
艳	丰⺈巴
臭	自犬
纤	纟千
玑	王几
棵	木日木
趁	走人彡
匠	匚斤
盈	乃又皿
翁	八厶羽
愁	禾火心
瞬	目㐄
婴	贝贝女
孝	耂子
颈	ス工页
倘	亻尚
浙	氵扌斤
谅	讠小
蔽	艹㡀攵
畅	申ㄋ
赠	贝曰
妮	女尸匕
莎	艹氵丿
尉	尸示寸
冻	冫小
跪	⻊⺈⺋
闯	门马
葡	艹勹甫
後	彳幺夊
厨	厂豆寸
鸭	甲鸟
颠	十页
遮	广廿辶
谊	讠宀且
圳	土川
吁	口一
仑	人匕
辟	尸口辛
瘤	疒田
嫂	女臼又
陀	阝宀匕
框	木匚王
谭	讠覀十
亨	了
钦	钅欠
庸	广肀
歉	兼欠
芝	艹之
吼	口子乚
甫	甫丶
衫	衤彡
摊	扌又隹
宴	宀日女
嘱	口尸冂
衷	亠口
娇	女丿
陕	阝一大
矩	矢匚コ
浦	氵甫
讶	讠牙
耸	人人耳
裸	衤日木
碧	王白石
摧	扌山隹
薪	艹立斤
淋	氵木木
耻	耳止
胶	月六乂
屠	尸耂日
鹅	手戈鸟
饥	饣几
盼	目八刀
脖	月子
虹	虫工
翠	羽亠十
崩	山月月
账	贝长
萍	艹氵丷
逢	夂丰辶
赚	贝兼
撑	扌手
翔	⺶羽
倡	亻日曰
绵	纟白巾
猴	犭亻矢
枯	木古
巫	工人人
昭	日刀口
怔	忄一止
渊	氵米
凑	冫大
溪	氵爫大
蠢	日虫
禅	礻丷十
阐	门丷十
旺	日王
寓	宀禺
藤	艹月氺
匪	匚非
伞	人丷十
碑	石十
挪	扌㇆阝
琼	王小
脂	月匕日
谎	讠艹
慨	忄旡
菩	艹立口
萄	艹勹缶
狮	犭リ巾
掘	扌尸凵
抄	扌小丿
岭	山亽龴
晕	日冖车
逮	彐水辶
砍	石欠
掏	扌勹缶
狄	犭火
晰	日木斤
罕	冖八干
挽	扌
脾	月十
舟	舟丶
痴	疒矢口
蔡	艹示
剪	䒑⺝刀
脊	冫⺝
弓	弓ㄋ
懒	忄束贝
叉	又丶丶
拐	扌口力
喃	口十
僚	亻大小
捐	扌口⺝
姊	女𠂔
骚	马又虫
拓	扌石
歪	不一止
粘	米卜口
柄	木𰀃人
坑	土亠几
陌	阝丆日
窄	穴乍
湘	氵木目
兆	儿冫
崖	山厂土
骄	马丿
刹	㐅朩刂
鞭	革亻
芒	艹亡
筋	⺮月力
聘	耳由丂
钩	钅勹厶
棍	木日匕
嚷	口亠
腺	月白水
弦	弓亠幺
焰	火⺈臼
耍	而女
俯	亻广寸
厘	厂里
愣	忄罒方
厦	厂丆夂
恳	艮心
饶	饣兀
钉	钅丁
寡	宀丆刀
憾	忄戊心
摔	扌亠十
叠	又又且
惹	艹心
喻	口亼刂
谱	讠䒑日
愧	忄鬼
煌	火白王
徽	糸
溶	氵宀谷
坠	阝人土
煞	⺈彐灬
巾	巾丨
滥	氵〢皿
洒	氵西
堵	土耂日
瓷	冫欠瓦
咒	吅几
姨	女一人
棒	木
郡	彐丿阝
浴	氵谷
媚	女目
稣	鱼禾
淮	氵隹
哎	口艹乂
屁	尸匕匕
漆	氵木氺
淫	氵爫壬
巢	巛日木
吩	口八刀
撰	扌巳八
啸	口肀八
滞	氵巾
玫	王攵
硕	石页
钓	钅勹丶
蝶	虫廿木
膝	月木氺
姚	女儿
茂	艹戊
躯	身匸㐅
吏	乂
猿	犭土
寨	𡨄木
恕	女口心
渠	氵匚木
戚	戊上小
辰	辰丶
舶	舟白
颁	八刀页
惶	忄白王
狐	犭瓜
讽	讠⺇乂
笨	⺮木一
袍	衤勹巳
嘲	口十月
啡	口非
泼	氵丶
衔	彳钅亍
倦	亻
涵	氵乛凵
雀	小隹
旬	勹日
僵	亻一一
撕	扌斤
肢	月十又
垄	龙土
夷	一弓人
逸	兔辶
茅	艹予丿
侨	亻丿
舆	车
窑	穴缶
涅	氵日土
蒲	艹氵甫
谦	讠兼
杭	木亠几
噢	口大
弊	㡀攵廾
勋	口贝力
刮	舌刂
郊	六乂阝
凄	冫一女
捧	扌
浸	氵彐又
砖	石二丶
鼎	目
篮	⺮〢皿
蒸	艹乛灬
饼	饣䒑廾
亩	亠田
肾	〢又⺝
陡	阝走
爪	爪丶
兔	兔丶
殷	彐殳
贞	卜贝
荐	艹子
哑	口一业
炭	山火
坟	土文
眨	目丿之
搏	扌甫寸
咳	口亥
拢	扌龙
舅	臼田力
昧	日未
擅	扌亠旦
爽	大乂乂
咖	口力口
搁	扌门口
禄	礻氺
雌	止匕隹
哨	口⺌⺝
巩	工几丶
绢	纟口⺝
螺	虫田糸
裹	亠日
昔	龷日
轩	干
谬	讠羽彡
谍	讠廿木
龟	⺈日乚
媳	女自心
姜	⺷女
瞎	目宀口
冤	冖兔
鸦	牙鸟
蓬	艹夂辶
巷	龷八巳
琳	王木木
栽	十戈木
沾	氵卜口
诈	讠乍
斋	文而
瞒	目艹人
彪	虎彡
厄	厂㔾
咨	冫欠口
纺	纟方
罐	缶艹隹
桶	木龴
壤	土亠
糕	米⺷灬
颂	八厶页
膨	月壴彡
谐	讠匕白
垒	厶厶土
咕	口古
隙	阝小小
辣	束
绑	纟阝
宠	宀龙
嘿	口黑
兑	丷口儿
霉	⻗母
挫	扌人土
稽	禾尤日
辐	车田
乞	乙ㄋ
纱	纟小丿
裙	衤彐口
嘻	口壴口
哇	口土土
绣	纟禾乃
杖	木一
塘	土广口
衍	彳氵亍
轴	由
攀	木乂手
膊	月甫寸
譬	尸口言
斌	文一止
祈	礻斤
踢	⻊日
肆	镸聿
坎	土欠
轿	车丿
棚	木月月
泣	氵立
屡	尸米女
躁	⻊口木
邱	一阝
凰	几白王
溢	氵䒑皿
椎	木隹
砸	石匚巾
趟	走尚
帘	穴巾
帆	巾几丶
栖	木西
窜	穴口丨
丸	丸丶
斩	斤
堤	土日
塌	土⺜羽
贩	贝⺁又
厢	厂木目
掀	扌斤欠
喀	口宀口
乖	千匕
谜	讠米辶
捏	扌日土
阎	门⺈臼
滨	氵宀
虏	虍力
匙	日匕
芦	艹户
苹	艹干丷
卸	卩
沼	氵刀口
钥	钅月
株	木丿未
祷	礻寸
剖	立口刂
熙	巳灬
哗	口亻十
劈	尸口刀
怯	忄土厶
棠	木
胳	月夂口
桩	木广土
瑰	王鬼
娱	女口大
娶	耳又女
沫	氵一木
嗓	口又木
蹲	⻊丷寸
焚	木木火
淘	氵勹缶
嫩	女束攵
韵	音勹冫
衬	衤寸
匈	勹㐅凵
钧	钅勹冫
竖	〢又立
峻	山厶夊
豹	豸勹丶
捞	扌力
菊	艹勹米
鄙	口十阝
魄	白鬼
兜	白儿
哄	口龷八
颖	匕禾页
镑	钅方
屑	尸⺌⺝
蚁	虫丶乂
壶	业
怡	忄厶口
渗	氵厶彡
秃	禾几
迦	力口辶
旱	日干
哟	口纟丶
咸	戊
焉	一止灬
谴	讠辶
宛	宀夕㔾
稻	禾爫臼
铸	钅寸
锻	钅殳
伽	亻力口
詹	⺈厂言
毙	匕匕匕
恍	忄小兀
贬	贝丿之
烛	火虫
骇	马亥
芯	艹心
汁	氵十
桓	木一旦
坊	土方
驴	马户
朽	木丂
靖	立龶⺝
佣	亻用
汝	氵女
碌	石氺
迄	乙辶
冀	匕八
荆	艹一刂
崔	山隹
雁	厂亻隹
绅	纟申
珊	王⺆一
榜	木方
诵	讠龴
傍	亻方
彦	厂彡
醇	酉子
笛	⺮由
禽	人文厶
勿	勹
娟	女口⺝
瞄	目艹田
幢	巾立里
寇	宀一攴
睹	目耂日
贿	贝⺝
踩	⻊爫木
霆	⻗壬廴
呜	口乌
拱	扌龷八
妃	女己
蔑	艹罒丶
谕	讠亼刂
缚	纟甫寸
诡	讠⺈⺋
篷	⺮夂辶
淹	氵大乚
腕	月宀㔾
煮	耂日灬
倩	亻龶⺝
卒	亠人十
勘	力
馨	士日
逗	豆辶
甸	勹田
贱	贝戋
炒	火小丿
灿	火山
敞	尚攵
蜡	虫龷日
囚	囗人
栗	覀木
辜	古辛
垫	扌丸土
妒	女户
魁	鬼⺀十
谣	讠爫缶
寞	宀䒤大
蜀	罒勹虫
甩	冂二乚
涯	氵厂土
枕	木冖
丐	一卜㇉
泳	氵丶
奎	大土土
泌	氵心丿
逾	亼⺝辶
叮	口丁
黛	亻弋黑
燥	火口木
掷	扌䒑阝
藉	艹耒日
枢	木匸㐅
憎	忄曰
鲸	鱼小
弘	弓厶
倚	亻大可
侮	亻母
藩	艹氵田
拂	扌弓
鹤	冖隹鸟
蚀	饣虫
浆	丬夕水
芙	艹夫
垃	土立
烤	火耂丂
晒	日西
霜	⻗木目
剿	巛日刂
蕴	艹纟皿
圾	土乃丶
绸	纟⺆口
屿	山丂一
氢	气ス工
驼	马宀匕
妆	丬女
捆	扌囗木
铅	钅几口
逛	犭王辶
淑	氵上又
榴	木田
丙	𰀃人
痒	疒羊
钞	钅小丿
蹄	⻊巾
犬	犬丶
躬	身弓
昼	尸㇏旦
藻	艹氵木
蛛	虫丿未
褐	衤曰亾
颊	一丷页
奠	丷酉大
募	䒤大力
耽	耳冖
蹈	⻊爫臼
陋	阝𰀃亾
侣	亻口口
魅	鬼未
岚	山⺇乂
侄	亻至
虐	虍匚一
堕	阝土
陛	阝匕土
莹	王丶
荫	艹阝月
狡	犭六乂
阀	门亻戈
绞	纟六乂
膏	高⺝
垮	土大丂
茎	艹ス工
缅	纟面
喇	口束刂
绒	纟戈
搅	扌⺍见
凳	癶豆几
梭	木厶夊
丫	丷丨丨
姬	女
诏	讠刀口
钮	钅丑
棺	木宀㠯
耿	耳火
缔	纟巾
懈	忄⺈牛
嫉	女疒矢
灶	火土
匀	勹冫
嗣	口
鸽	亼口鸟
澡	氵口木
凿	业凵
纬	纟韦
沸	氵弓
畴	田寸
刃	刀丶丶
遏	曰勹辶
烁	火小
嗅	口自犬
叭	口八
熬	龶灬
瞥	㡀攵目
骸	骨亥
奢	大耂日
拙	扌屮凵
栋	木小
毯	毛火火
桐	木冂
砂	石小丿
莽	艹犬廾
泻	氵冖一
坪	土干丷
梳	木
杉	木彡
晤	日五口
稚	禾隹
蔬	艹乛
蝇	虫黾
捣	扌山
顷	匕页
麽	麻丿厶
尴	尢〢皿
镖	钅覀示
诧	讠宀七
尬	尢人
硫	石
嚼	口爫寸
羡	⺷冫欠
沦	氵人匕
沪	氵户
旷	日广
彬	木木彡
芽	艹牙
狸	犭里
冥	冖日六
碳	石山火
咧	口歹刂
惕	忄日
暑	日耂日
咯	口夂口
萝	艹罒夕
汹	氵㐅凵
腥	月日生
窥	穴夫见
俺	亻大乚
潭	氵覀十
崎	山大可
麟	鹿米㐄
捡	扌亼一
拯	扌乛一
厥	厂䒑欠
澄	氵癶豆
萎	艹禾女
哉	十戈口
涡	氵口人
滔	氵爫臼
暇	日又
溯	氵䒑月
鳞	鱼米㐄
酿	酉丶艮
茵	艹因
愕	忄吅丂
瞅	目禾火
暮	䒤大日
衙	彳五亍
诫	讠戈廾
斧	八乂斤
兮	八丂
焕	火⺈大
棕	木宀示
佑	亻口
嘶	口斤
妓	女十又
喧	口宀旦
蓉	艹宀谷
删	⺆⺆刂
樱	木贝女
伺	亻
嗡	口八羽
娥	女手戈
梢	木⺌⺝
坝	土贝
蚕	一大虫
敷	甫方攵
澜	氵门丷
杏	木口
绥	纟爫女
冶	冫厶口
庇	广匕匕
挠	扌兀
搂	扌米女
倏	夂犬
聂	耳又又
婉	女宀㔾
噪	口口木
稼	禾宀豕
鳍	鱼耂日
菱	艹土夊
盏	戋皿
匿	匸艹口
吱	口十又
寝	宀丬又
揽	扌〢见
髓	骨辶
秉	禾彐
哺	口甫
矢	矢丶
啪	口扌白
帜	巾口八
邵	刀口阝
嗽	口束欠
挟	扌一大
缸	缶工
揉	扌予木
腻	月弋贝
驯	马川
缆	纟〢见
晌	日口
瘫	疒又隹
贮	贝宀一
觅	爫见
朦	月豕
僻	亻尸辛
隋	阝⺝
蔓	䒤罒又
咋	口乍
嵌	山甘欠
虔	虍文
畔	田丷
琐	王⺌贝
碟	石廿木
涩	氵刀止
胧	月龙
嘟	口耂阝
蹦	⻊山月
冢	冖豕丶
浏	氵文刂
裔	衣冂口
襟	衤木示
叨	口刀
诀	讠人
旭	九日
虾	虫一卜
簿	⺮氵寸
啤	口十
擒	扌人厶
枣	木冂⺀
嘎	口丆戈
苑	艹夕㔾
牟	厶牛
呕	口匸㐅
骆	马夂口
凸	一一
熄	火自心
兀	兀ㄋ
喔	口尸至
裳	衣
凹	一一
赎	贝十大
屯	一
膛	月土
浇	氵兀
灼	火勹丶
裘	一水
砰	石干丷
棘	木冂冂
橡	木象
碱	石戊
聋	龙耳
姥	女耂匕
瑜	王亼刂
毋	毋一
娅	女一业
沮	氵且
萌	艹日月
俏	亻⺌⺝
黯	黑音
撇	扌㡀攵
粟	覀米
粪	米龷八
尹	彐丿丿
苟	艹句
癫	疒十页
蚂	虫马
禹	丿虫冂
廖	广羽彡
俭	亻亼一
帖	巾卜口
煎	䒑⺝灬
缕	纟米女
窦	穴十大
簇	⺮方矢
棱	木土夊
叩	口卩
呐	口冂人
瑶	王爫缶
墅	里予土
莺	鸟
烫	氵ㄋ火
蛙	虫土土
歹	歹丶
伶	亻亽龴
葱	艹勹心
哮	口耂子
眩	目亠幺
坤	土申
廓	广阝
讳	讠韦
啼	口巾
乍	乍一
瓣	瓜辛
矫	矢丿
跋	⻊丶
枉	木王
梗	木一
厕	厂贝刂
琢	王豕丶
讥	讠几
釉	丿米由
窟	穴尸凵
敛	亼⺍攵
轼	弋工
庐	广户
胚	月不一
呻	口申
绰	纟卜十
扼	扌厂㔾
懿	豆心
炯	火冂口
竿	⺮干
慷	忄广水
虞	虍口大
锤	钅千二
栓	木人王
桨	丬夕木
蚊	虫文
磅	石方
孽	艹丿子
惭	忄斤
戳	羽隹戈
禀	亠囗示
鄂	吅一阝
馈	饣贝
垣	土一旦
溅	氵贝戋
咚	口夂⺀
钙	钅一㇉
礁	石隹灬
彰	音十彡
豁	宀丰谷
眯	目米
磷	石米㐄
雯	⻗文
墟	土虍业
迂	一辶
瞻	目⺈言
颅	卜尸页
琉	王
悼	忄卜十
蝴	虫古月
拣	扌
渺	氵目丿
眷	目
悯	忄门文
汰	氵大丶
慑	忄耳又
婶	女宀申
斐	非文
嘘	口虍业
镶	钅亠
炕	火亠几
宦	宀臣
趴	⻊八
绷	纟月月
窘	穴彐口
襄	亠吅
珀	王白
嚣	吅页吅
拚	扌厶廾
酌	酉勹丶
浊	氵虫
毓	母
撼	扌戊心
嗜	口耂日
扛	扌工
峭	山⺌⺝
磕	石土皿
翘	兀羽
槽	木一曰
淌	氵尚
栅	木⺆一
颓	禾几页
熏	千黑
瑛	王艹大
颐	页
忖	忄寸
牡	牜土
缀	纟又又
徊	彳囗口
梨	禾刂木
肪	月方
涕	氵丷
惫	夂田心
摹	䒤大手
踱	⻊广又
肘	月寸
熔	火宀谷
挚	扌丸手
氯	气氺
凛	冫亠示
绎	纟又
庶	广廿灬
脯	月甫
迭	丿夫辶
睦	目土土
窍	穴工丂
粥	弓米弓
庵	广大乚
沧	氵人㔾
怠	厶口心
沁	氵心
奕	亦大
咙	口龙
氨	气宀女
矗	十一
盔	火皿
拇	扌母
沛	氵一巾
榻	木⺜羽
揣	扌山而
崭	山斤
鞘	革⺌⺝
鞠	革勹米
垦	艮土
洽	氵亼口
唾	口千二
橱	木厂寸
仕	亻士
蜘	虫矢口
痰	疒火火
袜	衤一木
峙	山土寸
柬	束丷
蝉	虫丷十
蟹	⺈用虫
谏	讠束丷
鹃	口⺝鸟
擎	艹句手
皓	白⺧口
朕	月䒑大
疤	疒巴
禺	禺丶
铲	钅厂
酶	酉母
钝	钅一
氓	亡民
匣	匚甲
弧	弓瓜
峨	山手戈
锥	钅隹
揪	扌禾火
杠	木工
吭	口亠几
崛	山尸凵
诬	讠工人
冉	冉一
抒	扌予
庚	广彐人
悍	忄日干
靡	麻非
晦	日母
醋	酉龷日
壕	土豕
锯	钅尸古
夭	丿大
咦	口一人
侈	亻夕夕
婢	女十
猾	犭骨
徘	彳非
硝	石⺌⺝
煽	火户羽
皂	白七
舵	舟宀匕
嗦	口糸
狈	犭贝
靴	革亻
捂	扌五口
疮	疒人㔾
郝	土阝
苛	艹可
秽	禾山夕
茜	艹西
搓	扌⺶工
芸	艹云
酱	丬夕酉
赁	亻壬贝
檐	木⺈言
饷	饣口
蕉	艹隹灬
铀	钅由
苔	艹厶口
赦	土攵
缎	纟殳
舷	舟亠幺
筷	⺮忄人
朔	䒑月
婪	木木女
紊	文糸
厮	厂斤
婿	女疋⺝
寥	宀羽彡
兢	古儿儿
糙	米⺧辶
卦	土土卜
槐	木鬼
扒	扌八
裴	非衣
祀	礻巳
埔	土甫
絮	女口糸
芭	艹巴
屉	尸廿㇗
痪	疒⺈大
霄	⻗⺌⺝
绽	纟宀疋
宵	宀⺌⺝
邑	口巴
霖	⻗木木
岔	八刀山
饵	饣耳
茄	艹力口
韧	韦刀丶
琪	王
邹	⺈彐阝
瑚	王古月
憋	㡀攵心
殆	歹厶口
噜	口鱼日
忒	弋心
忿	八刀心
衅	丿皿
淳	氵子
悖	忄子
髦	髟毛
孜	子攵
粤	米丂
隘	阝䒑皿
濒	氵止页
铮	钅⺈
畸	田大可
剔	日勹刂
坞	土乌
篱	竹文厶
淀	氵宀疋
蓦	䒤大马
唬	口虎
锣	钅罒夕
汀	氵丁
趾	⻊止
缉	纟口耳
嫦	女巾
斟	十
鞍	革宀女
扳	扌⺁又
拴	扌人王
诅	讠且
谟	讠䒤大
呃	口厂㔾
懦	忄⻗而
逞	口王辶
犁	禾刂牛
忏	忄千
拧	扌宀丁
亥	亥丶
佟	亻夂⺀
叱	口
舜	夕㐄
绊	纟丷
龚	龙龷八
腮	月田心
邸	七阝
椒	木上又
蔚	艹尸寸
湛	氵㇗
狩	犭宀寸
眶	目匚王
栈	木戋
薇	艹几
肮	月亠几
瀑	氵日氺
渣	氵木旦
褂	衤土卜
叽	口几
臀	尸龷⺝
妞	女丑
巍	山禾鬼
唔	口五口
疚	疒㇏
鲤	鱼里
戎	戈
肇	户攵聿
笃	⺮马
辙	攵
娴	女门木
阮	阝一兀
札	木乚ㄋ
懊	忄大
焘	寸灬
恤	忄丿皿
疹	疒人彡
潇	氵艹八
铝	钅口口
涤	氵夂木
恃	忄土寸
喽	口米女
砌	石七刀
遁	⺁十辶
楞	木罒方
阱	阝井
咎	夂卜口
洼	氵土土
炳	火𰀃人
噬	口⺮人
枫	木⺇乂
拷	扌耂丂
哆	口夕夕
矶	石几
苇	艹韦
翩	户羽
窒	穴至
侬	亻冖
靶	革巴
胰	月一人
芜	艹无
辫	纟辛
嚎	口豕
妾	立女
幌	巾日兀
踉	⻊丶艮
佃	亻田
葫	艹古月
皖	白宀兀
拽	扌曰丿
滤	氵虍心
睬	目爫木
俞	亼⺝刂
匕	匕ㄋ
谤	讠方
嗤	口屮虫
捍	扌日干
孵	卵爫子
倪	亻臼儿
瘾	疒阝心
敝	㡀攵
匡	匚王
磋	石⺶工
绫	纟土夊
淆	氵㐅⺝
尧	兀
蕊	艹心心
烘	火龷八
璋	王音十
亢	亠几
轧	乚ㄋ
赂	贝夂口
蝗	虫白王
榆	木亼刂
骏	马厶夊
诛	讠丿未
勺	勹丶丶
梵	木木丶
炽	火口八
笠	⺮立
颌	亼口页
闸	门甲
狒	犭弓
樊	木乂大
镕	钅宀谷
垢	土
瘟	疒日皿
缪	纟羽彡
菇	艹女古
琦	王大可
剃	丷𢎨刂
迸	䒑廾辶
溺	氵弓冫
炫	火亠幺
惚	忄勹心
嗨	口氵母
陨	阝口贝
赃	贝广土
羁	罒革马
臻	至禾
嘀	口古
膳	月羊口
赣	音十贝
踌	⻊寸
殉	歹勹日
桔	木士口
瞿	目目隹
闽	门虫
豚	月豕
掺	扌厶彡
沌	氵一
惰	忄⺝
喳	口木旦
椭	木阝⺝
咪	口米
霎	⻗立女
侃	亻口
猝	犭亠十
窖	穴⺧口
戮	羽人戈
祠	礻
瞩	目尸冂
菁	艹龶⺝
躇	⻊艹日
佬	亻耂匕
肋	月力
咄	口屮凵
忡	忄口丨
雍	亠乡隹
忱	忄冖
蕾	艹⻗田
跄	⻊人㔾
硅	石土土
伎	亻十又
炊	火欠
钊	钅刂
蝠	虫田
屎	尸米
拭	扌弋工
谛	讠巾
褪	衤艮辶
丞	乛水一
卉	十廾
隧	阝丷辶
茸	艹耳
钳	钅甘
啃	口止⺝
伢	亻牙
闺	门土土
舔	舌一⺗
蹬	⻊癶豆
挛	亦手
眺	目儿
袱	衤亻犬
陇	阝龙
殴	匸㐅殳
柿	木亠巾
梧	木五口
惺	忄日生
弛	弓也
侥	亻兀
琛	王冖木
捅	扌龴
酝	酉云
薯	艹罒日
曳	日㇂丿
澈	氵攵
锈	钅禾乃
稠	禾⺆口
眸	目厶牛
咆	口勹巳
簧	⺮龷八
鸥	匸㐅鸟
疡	疒ㄋ
渎	氵十大
汲	氵乃丶
嬉	女壴口
脓	月冖
骡	马田糸
穗	禾惠心
槛	木〢皿
拎	扌亽龴
巳	巳ㄋ
邢	一廾阝
廿	廿一
搀	扌⺀
曙	日罒日
樵	木隹灬
隅	阝禺
筛	⺮リ巾
谒	讠曰亾
倭	亻禾女
痹	疒田丌
猖	犭日曰
佯	亻羊
肛	月工
奚	爫幺大
甭	不用
抨	扌干丷
蛾	虫手戈
唠	口力
荧	火
嵩	山高
漱	氵束欠
酋	丷酉
攘	扌亠
诘	讠士口
篡	⺮目厶
睿	八目
噩	王口口
怅	忄长
盎	大皿
徙	彳止龰
鞅	革大
漓	氵文厶
祟	屮凵示
睫	目一龰
攸	攵
翎	亽龴羽
呛	口人㔾
筐	⺮匚王
堑	车斤土
檀	木亠旦
寅	宀一八
磊	石石石
驭	马又
惘	忄冂亡
吠	口犬
驮	马大
瑙	王巛一
炬	火匚コ
痉	疒ス工
曝	日日氺
恺	忄山己
胺	月宀女
萤	虫
敕	束攵
筝	⺮⺈
幡	巾丿田
霹	⻗尸辛
竺	⺮二
烙	火夂口
毗	田匕匕
鸠	九鸟
埠	土丿十
蒜	艹示示
阜	丿㠯十
嘈	口一曰
乒	一丿
帷	巾隹
啄	口豕丶
鳌	龶鱼
毡	毛卜口
阙	门䒑欠
褥	衤辰寸
搔	扌又虫
笋	⺮彐丿
冕	⺜
狞	犭宀丁
韶	音刀口
骼	骨夂口
蔼	艹讠亾
烹	了灬
奄	大日乚
嫖	女覀示
沐	氵木
噗	口业夫
岑	山亽㇆
蛟	虫六乂
掳	扌虍力
咏	口丶
弩	女又弓
捻	扌亽心
圃	囗甫
孚	爫子
悴	忄亠十
诣	讠匕日
呱	口瓜
祁	礻阝
捶	扌千二
钠	钅冂人
袄	衤丿大
澎	氵壴彡
氮	气火火
恪	忄夂口
雏	⺈彐隹
撮	扌日又
堰	土匚女
彷	彳方
鹦	贝贝鸟
晖	日冖车
犀	尸水牛
腑	月广寸
沽	氵古
橄	木乛攵
掐	扌⺈臼
亵	亠扌
龋	齿丿冂
嗒	口艹口
咀	口且
祺	礻
锚	钅艹田
匾	匸户
乓	一丶
萃	艹亠十
贻	贝厶口
揖	扌口耳
觑	虍业见
吝	文口
憔	忄隹灬
羌	⺶乚ㄋ
诲	讠母
砾	石小
蠕	虫⻗而
肴	㐅⺝
撩	扌大小
坍	土⺆亠
酥	酉禾
袅	衣
黝	黑幺力
俾	亻十
嫣	女一灬
穹	穴弓
秧	禾大
妊	女壬
溉	氵旡
鹊	龷日鸟
聿	聿丨
疙	疒乙
蘑	艹麻石
睾	丿罒
楷	木匕白
酵	酉耂子
茹	艹女口
锌	钅辛
滇	氵十
辗	尸
纂	⺮目糸
圭	土土
幔	巾曰又
褒	亠亻
揍	扌大
诽	讠非
倔	亻尸凵
腓	月非
颉	士口页
锄	钅且力
嗔	口十
磺	石龷八
攒	扌⺧贝
瘩	疒艹口
雳	⻗厂力
吆	口幺
悚	忄束
墩	土攵
彝	彑米廾
囱	夂一
逍	⺌⺝辶
辄	耳㇗
桅	木⺈⺋
俨	亻一丿
纶	纟人匕
悸	忄禾子
殃	歹大
帧	巾卜贝
俐	亻禾刂
绮	纟大可
袒	衤旦
籽	米子
孰	子丸
愫	忄龶糸
拌	扌丷
橙	木癶豆
暨	旡旦
敖	龶攵
赘	龶贝
抉	扌人
淤	氵方⺀
剌	束刂
娼	女日曰
顼	王页
葵	艹癶大
哝	口冖
酣	酉甘
麓	木木鹿
钵	钅木一
琅	王丶艮
簸	⺮皮
禾	禾丶
铢	钅丿未
璧	尸口丶
娠	女辰
彗	丰丰彐
惋	忄宀㔾
腋	月亠
螂	虫丶阝
阪	阝⺁又
掣	牛巾手
劾	亥力
沥	氵厂力
粱	氵刀米
嚓	口宀示
惮	忄丷十
氖	气乃
捎	扌⺌⺝
羔	⺷灬
俟	亻厶矢
渲	氵宀旦
榄	木〢见
茧	艹虫
霓	⻗臼儿
鹉	一弋鸟
胥	疋⺝
琶	王王巴
撬	扌毛毛
橘	木予口
拈	扌卜口
笆	⺮巴
痊	疒人王
亟	了口一
渭	氵田⺝
狙	犭且
珂	王可
刨	勹巳刂
蜕	虫丷儿
谚	讠彡
憧	忄立里
瞟	目覀示
馒	饣曰又
拗	扌幺力
帚	彐冖巾
钗	钅又丶
哧	口土
喋	口廿木
箫	⺮肀八
刁	一一
怦	忄干丷
缭	纟大小
迥	冂口辶
湄	氵目
磐	舟殳石
渝	氵亼刂
冗	冖几
闵	门文
噶	口䒤亾
黏	禾人口
蕃	艹丿田
弼	弓丆弓
驿	马又
淄	氵巛田
饺	饣六乂
踞	⻊尸古
韬	韦爫臼
婷	女丁
唆	口厶夊
蜒	虫丿廴
偎	亻田
榨	木穴乍
漉	氵鹿
碉	石⺆口
皈	白⺁又
矜	予丿㇆
笈	⺮乃丶
枷	木力口
鲨	氵小鱼
蹑	⻊耳又
瀚	氵十羽
酪	酉夂口
谑	讠虍一
癖	疒尸辛
烬	火尸⺀
揩	扌匕白
炙	火
蜷	虫
侏	亻丿未
凋	冫⺆口
漪	氵犭可
悻	忄土
蹋	⻊⺜羽
讪	讠山
搐	扌亠田
碘	石
帛	白巾
诠	讠人王
碾	石尸
擂	扌⻗田
苯	艹木一
诃	讠可
铎	钅又
戊	戊丶
荀	艹勹日
驹	马句
攫	扌目又
憬	忄日小
哽	口一
踵	⻊丿一
蟒	虫艹廾
漾	氵⺷
啧	口龶贝
吮	口厶儿
楠	木十
氟	气弓
怂	人人心
叼	口一
竣	立厶夊
偕	亻匕白
漩	氵方疋
蹭	⻊曰
翌	羽立
臆	月音心
挝	扌寸辶
绚	纟勹日
崽	山田心
糜	麻米
瘢	疒舟殳
跤	⻊六乂
阑	门束丷
恬	忄舌
豢	豕
汶	氵文
跷	⻊兀
琵	王王匕
憨	乛耳心
蜗	虫口人
螅	虫自心
惴	忄山而
戟	十日戈
匮	匚贝
恙	⺷心
抿	扌民
桢	木卜贝
笺	戋
蛤	虫亼口
瞳	目立里
瓢	覀示瓜
秤	禾干丷
跺	⻊几木
潦	氵大小
芹	艹斤
哒	口大辶
饬	饣力
栩	木羽
曦	日⺷戈
骷	骨古
嫡	女古
卤	卜囗乂
丕	不一一
鬓	髟宀
梓	木辛
嗖	口臼又
惦	忄广口
浚	氵厶夊
咔	口上卜
藐	艹豸儿
荃	艹人王
唧	口卩
玺	⺈小丶
汛	氵⺄十
铐	钅耂丂
髅	骨米女
渤	氵力
皿	皿一
箍	⺮扌巾
馅	饣⺈臼
汾	氵八刀
戍	戊丶丶
痔	疒土寸
褶	衤羽白
聆	耳亽龴
涎	氵丿廴
汞	工水
渍	氵龶贝
奂	⺈大
巅	山十页
疣	疒尤
傩	亻又隹
逵	土八辶
耆	耂匕日
蟋	虫丿心
鳄	鱼吅丂
讹	讠亻
膺	广亻⺝
蹿	⻊穴丨
筏	⺮亻戈
釜	八乂䒑
沂	氵斤
坯	土不一
峦	亦山
茬	艹土
摒	扌尸廾
蟀	虫亠十
撵	扌夫车
浒	氵讠十
缤	纟宀
嵋	山目
珑	王龙
苞	艹勹巳
瑾	王革二
泵	石水
钾	钅甲
暧	日又
赓	广彐贝
叟	臼丨又
佚	亻丿夫
沓	水日
撂	扌田口
蛊	虫皿
甥	生田力
璐	王⻊口
晏	日宀女
瘪	疒自匕
漳	氵音十
阉	门大乚
蹂	⻊予木
鳃	鱼田心
琏	王车辶
湃	氵龵丰
辘	车鹿
僭	亻旡曰
躏	⻊艹隹
鼾	自田干
懵	忄艹目
镰	钅广兼
寐	宀爿未
褚	衤耂日
攥	扌⺮糸
涧	氵门日
蝙	虫户
脐	月文
辕	土
涣	氵⺈大
杞	木己
煜	火日立
骥	马八
傣	亻氺
嗳	口又
祯	礻卜贝
酉	酉一
秸	禾士口
捺	扌大示
瑕	王又
鑫	金金金
馋	饣⺀
窿	穴阝生
楔	木丰大
胱	月小兀
荔	艹力力
蟆	虫䒤大
湍	氵山而
屹	山乙
遐	二辶
轲	车可
镯	钅罒虫
缰	纟一一
桦	木亻十
炖	火一
钡	钅贝
羚	⺶亽龴
啬	十䒑口
诩	讠羽
绯	纟非
掖	扌亠
箓	⺮氺
涸	氵囗古
鸳	夕㔾鸟
塾	子土
呸	口不一
抡	扌人匕
擞	扌米攵
熹	壴口灬
坷	土可
瓮	八厶瓦
亘	一旦
嗟	口⺶工
筵	⺮丿廴
跛	⻊皮
汕	氵山
欤	丂一欠
壑	谷土
颍	匕水页
溥	氵甫寸
姗	女⺆一
踊	⻊龴
枭	木
暄	日宀旦
稷	禾田夊
跚	⻊⺆一
涟	氵车辶
瀛	氵赢女
笙	⺮生
滕	月氺
踝	⻊日木
贰	弋二贝
瞰	目乛攵
恻	忄贝刂
嚏	口疋
迢	刀口辶
獗	犭厂欠
邯	甘阝
睑	目亼一
赡	贝⺈言
萦	糸
珥	王耳
酮	酉冂
璞	王业夫
羹	⺷灬大
缄	纟戊
晾	日小
俸	亻
媲	女匕
鸾	亦鸟
恿	龴心
蜿	虫宀㔾
犊	牜十大
讷	讠冂人
扈	户口巴
蜈	虫口大
翟	羽隹
藕	艹耒禺
戌	戊一一
蓓	艹亻口
鋆	土勹金
谩	讠曰又
谀	讠臼人
卯	卯丨
谙	讠音
岐	山十又
蝎	虫曰亾
荼	艹亼朩
镀	钅广又
椰	木耳阝
甄	覀土瓦
蟾	虫⺈言
蹊	⻊爫大
泞	氵宀丁
撸	扌鱼日
螃	虫方
檬	木豕
猓	犭日木
蔷	艹十口
羲	⺷禾戈
瘸	疒力人
蘸	艹酉灬
蔗	艹广灬
傀	亻鬼
蚌	虫丰
锢	钅囗古
遽	虍豕辶
邃	穴丷辶
恚	土土心
皑	白山己
锵	钅丬寸
簌	⺮束欠
焙	火立口
昊	旦大
鹳	艹吅鸟
睽	目癶大
刽	人云刂
鳖	㡀攵鱼
噎	口豆
呗	口贝
寰	宀罒
唷	口⺝
殡	歹宀
淖	氵卜十
诰	讠⺧口
恣	冫欠心
睐	目一米
婵	女丷十
榈	木门口
氦	气亥
靳	革斤
蛹	虫龴
鸯	大鸟
惬	忄匚大
蹙	戊上足
诙	讠火
眈	目冖
罡	罒一止
缮	纟羊口
胤	儿幺月
皋	白大十
蛀	虫丶王
偌	亻艹口
疵	疒止匕
绛	纟夂㐄
葆	艹亻木
黔	黑亽㇆
喙	口彑
烽	火夂丰
儡	亻田田
佼	亻六乂
斓	文门丷
嫔	女宀
颚	吅一页
龈	齿艮
盅	口丨皿
娓	女尸毛
坂	土⺁又
町	田丁
芥	艹人
瘠	疒冫⺝
阂	门亥
挎	扌大丂
橇	木毛毛
荟	艹人云
啜	口又又
垛	土几木
淇	氵
瓒	王⺧贝
篓	⺮米女
虱	⺄丿虫
跻	⻊文
龛	亼口龙
蹒	⻊艹人
髯	髟冉
瞠	目土
痫	疒门木
掂	扌广口
潼	氵立里
酰	酉⺧儿
镁	钅⺷大
灸	丶火
腆	月
筱	⺮攵
谆	讠子
骋	马由丂
壬	壬一
茗	艹夕口
椋	木小
蛔	虫囗口
潺	氵尸子
扉	户非
耘	耒云
槟	木宀
雹	⻗勹巳
甬	龴
谥	讠䒑皿
淞	氵木厶
燎	火大小
蕙	艹惠心
蚪	虫⺀十
蜻	虫龶⺝
郸	丷日阝
轶	丿夫
狰	犭⺈
楣	木目
捋	扌爫寸
涓	氵口⺝
荪	艹子小
娄	米女
麝	鹿身寸
蚤	又丶虫
薰	艹千黑
醮	酉隹灬
搪	扌广口
谧	讠心皿
湮	氵覀土
辍	又又
瞌	目土皿
梆	木阝
樟	木音十
茉	艹一木
岖	山匸㐅
臼	臼一
癣	疒鱼羊
穑	禾十口
玷	王卜口
馍	饣䒤大
呷	口甲
萼	艹吅丂
妩	女无
伫	亻宀一
彤	⺆亠彡
莓	艹母
岬	山甲
媛	女爫又
惆	忄⺆口
鳎	鱼⺜羽
啾	口禾火
囔	口
蜓	虫壬廴
孺	子⻗而
徇	彳勹日
徵	王
焊	火日干
岱	亻弋山
昵	日尸匕
卅	一川
飙	犬犬乂
邙	亡阝
痞	疒不口
隼	隹十
恫	忄冂
怆	忄人㔾
桀	夕㐄木
绶	纟又
裆	衤彐
盂	一皿
桧	木人云
蚓	虫弓丨
抠	扌匸㐅
嗷	口龶攵
槌	木丿辶
痘	疒豆
痢	疒禾刂
芮	艹冂人
蚣	虫八厶
闩	门一一
铿	钅〢土
飓	⺇乂
疱	疒勹巳
蝌	虫禾十
撅	扌厂欠
蚯	虫一
斡	十日十
窠	穴日木
荚	艹一大
耷	大耳
砚	石见
牒	片廿木
赈	贝辰
煦	日句灬
嗫	口耳又
耙	耒巴
榕	木宀谷
鞑	革大辶
袤	亠予
谌	讠㇗
醺	酉千黑
秆	禾干
徨	彳白王
橹	木鱼日
翡	非羽
缨	纟贝女
锹	钅禾火
嵇	禾尤山
圪	土乙
髻	髟士口
嗬	口艹可
辎	巛田
痣	疒士心
娩	女
谄	讠⺈臼
蛐	虫曲
鹞	爫缶鸟
翱	白大羽
庖	广勹巳
籁	⺮束贝
蓿	艹宀日
鳗	鱼曰又
疟	疒匚一
鲇	鱼卜口
嚅	口⻗而
瘀	疒方⺀
颔	亽㇆页
黜	黑屮凵
黠	黑士口
濑	氵束贝
馁	饣爫女
洵	氵勹日
忐	上心
忑	一卜心
砥	石丶
咂	口匚巾
罹	罒忄隹
糠	米广水
匝	匚巾
偃	亻匚女
淙	氵宀示
纫	纟刀丶
喏	口艹口
闾	门口口
祛	礻土厶
蛰	扌丸虫
腼	月面
涝	氵力
曜	日羽隹
厩	厂旡
疽	疒且
闰	门王
洄	氵囗口
煊	火宀旦
汐	氵夕
藓	艹鱼羊
璜	王龷八
铬	钅夂口
渥	氵尸至
靼	革旦
酗	酉㐅凵
苓	艹亽龴
噤	口木示
咫	尸㇏八
椿	木日
鲫	鱼卩
锭	钅宀疋
罔	冂䒑亡
锺	钅丿一
匍	勹甫
祗	礻丶
锰	钅子皿
岌	山乃丶
馀	饣亼朩
畹	田宀㔾
糯	米⻗而
胫	月ス工
熠	火羽白
銮	亦金
沅	氵一兀
棣	木彐水
旌	方生
豌	豆宀㔾
孢	子勹巳
镭	钅⻗田
驸	马亻寸
腌	月大乚
盹	目一
熵	火口
镐	钅高
馐	饣⺶丑
嘤	口贝女
癞	疒束贝
骰	骨殳
韭	非一一
阖	门土皿
瞑	目冖六
裨	衤十
宕	宀石
戾	户犬
镌	钅隹乃
溟	氵冖六
牍	片十大
隽	隹乃
婊	女龶
鹄	⺧口鸟
埂	土一
拄	扌丶王
娲	女口人
虬	虫乚ㄋ
萱	艹宀旦
啵	口氵皮
蠡	彑虫
芋	艹一
胭	月因
豺	豸丿
啻	巾口
褛	衤米女
蛆	虫且
柠	木宀丁
掰	龵八手
篆	⺮彑
倌	亻宀㠯
咛	口宀丁
蛭	虫至
谡	讠田夊
荨	艹彐寸
莞	艹宀兀
澹	氵⺈言
纭	纟云
潞	氵⻊口
郅	至阝
弋	弋丶
飕	⺇乂又
螳	虫土
胄	由⺝
蟑	虫音十
猥	犭田
宓	宀心丿
昙	日云
锏	钅门日
蟠	虫丿田
柑	木甘
烯	火㐅巾
匐	勹田
濮	氵亻夫
蟮	虫羊口
祐	礻口
仄	厂人
偈	亻曰亾
蜃	辰虫
箴	戊
粼	米夕巜
嗥	口白十
褴	衤〢皿
蕨	艹厂欠
蓟	艹鱼刂
圩	土一
孪	亦子
杳	木日
魇	厂犬鬼
荤	车
诿	讠禾女
簪	⺮旡曰
氲	气日皿
摞	扌田糸
飒	立⺇乂
镂	钅米女
舀	爫臼
夙	几歹
臧	臣
蒿	艹高
貂	豸刀口
蜥	虫木斤
蹩	㡀攵足
噼	口尸辛
钛	钅大丶
钚	钅不
獾	犭艹隹
濂	氵广兼
铠	钅山己
皙	木斤白
霭	⻗讠亾
鲈	鱼卜尸
叵	匚口
霾	⻗豸里
泯	氵民
碴	石木旦
鸵	鸟宀匕
峪	山谷
饕	口丂食
瘁	疒亠十
睢	目隹
鬃	髟宀示
迩	⺈小辶
纣	纟寸
夔	䒑自夊
垠	土艮
饨	饣一
榭	木身寸
隍	阝白王
娑	氵小女
篝	冉
榔	木丶阝
洌	氵歹刂
浜	氵
鲑	鱼土土
谔	讠吅丂
汩	氵曰
浣	氵宀兀
舐	舌七
瞭	目大小
忻	忄斤
咻	口亻木
鹑	子鸟
唑	口人土
懋	木予心
皎	白六乂
诒	讠厶口
麾	麻毛
辏	车大
氐	七丶
冽	冫歹刂
箕	⺮
俚	亻里
汴	氵亠卜
宸	宀辰
芍	艹勹丶
捱	扌厂土
摈	扌宀
摺	扌羽白
簦	⺮癶豆
箔	⺮氵白
咝	口纟纟
孀	女⻗目
怏	忄大
谝	讠户
砧	石卜口
馕	饣
耄	耂匕毛
罂	贝贝缶
漕	氵一曰
沣	氵丰
栾	亦木
榘	矢匚木
烷	火宀兀
榷	木冖隹
俑	亻龴
沱	氵宀匕
缜	纟十
鹫	小鸟
蛳	虫リ巾
剽	覀示刂
衢	彳目亍
泗	氵四
臊	月口木
瘴	疒音十
酚	酉八刀
纾	纟予
晁	日儿
孛	子
炀	火ㄋ
叁	厶大三
憩	舌自心
掬	扌勹米
椤	木罒夕
啮	口齿
畿	幺幺田
掸	扌丷十
镣	钅大小
骁	马兀
椽	木彑
侗	亻冂
滦	氵亦木
荩	艹尸⺀
泓	氵弓厶
蚱	虫乍
癜	疒尸殳
酯	酉匕日
癸	癶一大
蚜	虫牙
扪	扌门
庑	广无
歆	音欠
蝮	虫夊
蹶	⻊厂欠
弈	亦廾
庋	广十又
喟	口田⺝
滂	氵方
啕	口勹缶
蛎	虫厂
獭	犭束贝
槁	木高
翊	立羽
龊	齿足
邺	业阝
莘	艹辛
燮	言火又
剁	几木刂
觐	革二见
铛	钅彐
谗	讠⺀
镍	钅自木
臃	月亠隹
墒	土口
晔	日亻十
燔	火丿田
嘭	口壴彡
涿	氵豕丶
醯	酉皿
箩	⺮罒夕
鄱	丿米阝
睨	目臼儿
诤	讠⺈
坳	土幺力
鹭	⻊夂鸟
砷	石申
唏	口㐅巾
伲	亻尸匕
猬	犭田⺝
琥	王虎
殁	歹殳
蚩	屮一虫
泾	氵ス工
缥	纟覀示
殓	歹亼一
鳅	鱼禾火
氰	气龶⺝
诋	讠丶
刍	⺈彐
芷	艹止
嶙	山米㐄
逅	辶
舫	舟方
呓	口艹乙
唰	口尸刂
茁	艹屮凵
馑	饣革二
妫	女丶丶
骧	马亠
苷	艹甘
擢	扌羽隹
峋	山勹日
袂	衤人
懑	氵艹心
蓑	艹亠
涞	氵一米
祉	礻止
踹	⻊山而
掇	扌又又
沏	氵七刀
诳	讠犭王
噫	口音心
饽	饣子
饪	饣壬
绺	纟夂口
谘	讠冫口
飧	夕食
迳	ス工辶
铡	钅贝刂
枞	木人人
熨	尸示火
鋈	氵丿金
荭	艹纟工
赊	贝人示
俦	亻寸
戛	丆目戈
湎	氵面
幺	幺丶
凇	冫木厶
芪	艹七
觯	⺈用十
龌	齿尸至
挞	扌大辶
嬴	赢女
苻	艹亻寸
嘁	口戊小
鞯	革艹子
肽	月大丶
恸	忄云力
迨	厶口辶
钰	钅王丶
儆	亻艹攵
觎	亼⺝见
讫	讠乙
滓	氵宀辛
僮	亻立里
媾	女冉
龇	齿止匕
胯	月大丂
涮	氵尸刂
绾	纟宀㠯
杈	木又丶
赳	走丩
斛	⺈用十
觥	⺈用兀
疸	疒旦
卞	亠卜
愠	忄日皿
拮	扌士口
庠	广羊
烨	火亻十
龢	亼吅禾
菠	艹氵皮
窈	穴幺力
罄	士缶
囤	囗一
弁	厶廾
奘	爿士大
咣	口小兀
缫	纟巛木
腴	月臼人
缈	纟目丿
喵	口艹田
潢	氵龷八
遛	田辶
柚	木由
郏	一丷阝
荻	艹犭火
藜	艹禾水
琨	王日匕
镳	钅鹿灬
雉	矢隹
橐	石木
骈	马䒑廾
蛉	虫亽龴
艮	艮丶
搽	扌艹木
濡	氵⻗而
寮	宀大小
柩	木匚丶
佗	亻宀匕
啷	口丶阝
诜	讠⺧儿
偻	亻米女
夯	大力
闱	门韦
谖	讠爫又
夥	日木夕
枸	木句
膑	月宀
虻	虫亡
筠	⺮土冫
埽	土彐巾
笞	⺮厶口
臾	臼人
婀	女阝可
珞	王夂口
粑	米巴
怵	忄木丶
绻	纟
殒	歹口贝
觊	山己见
崂	山力
颧	艹吅页
嗑	口土皿
榛	木禾
昱	日立
蜴	虫日
鳝	鱼羊口
噙	口人厶
淼	水水水
矾	石几丶
硼	石月月
囿	囗⺝
泅	氵囗人
邂	⺈用辶
钜	钅匚コ
蠹	石虫
垩	一业土
乩	卜口乚
嗝	口鬲
淦	氵金
樽	木丷寸
诮	讠⺌⺝
揆	扌癶大
啐	口亠十
淅	氵木斤
榉	木⺍
馗	九䒑自
辔	纟车口
暹	日隹辶
骛	予丿马
鱿	鱼尤
苫	艹卜口
犷	犭广
獠	犭大小
詈	罒言
竦	立束
篙	⺮高
诨	讠冖车
铰	钅六乂
馄	饣日匕
蜚	非虫
峒	山冂
滢	氵丶
琬	王宀㔾
靓	龶⺝见
狻	犭厶夊
璨	王歺米
犟	弓口牛
鸬	卜尸鸟
螨	虫艹人
芩	艹亽㇆
嘹	口大小
锟	钅日匕
蜇	扌斤虫
洹	氵一旦
栉	木艹卩
俪	亻一
钍	钅土
锨	钅斤欠
瑁	王⺜目
壹	豆
痿	疒禾女
竑	立厶
粕	米白
犄	牜大可
瘙	疒又虫
饯	饣戋
抟	扌二丶
衲	衤冂人
踮	⻊广口
龅	齿勹巳
愎	忄夊
馥	禾日夊
梏	木⺧口
讣	讠卜
邝	广阝
艿	艹乃
趺	⻊夫
鲟	鱼彐寸
剜	宀夕刂
绉	纟⺈彐
罅	缶虍
笥	
衩	衤又丶
姣	女六乂
斫	石斤
鹗	吅一鸟
爻	乂乂
猕	犭弓小
晗	日亽口
铩	钅㐅朩
窕	穴儿
仨	亻三
搡	扌又木
崴	山戊女
酢	酉乍
檄	木白攵
佞	亻二女
璀	王山隹
岷	山民
舛	夕㐄
邕	巛口巴
闿	门山己
铂	钅白
霁	雨文
犒	牜高
馏	饣田
阈	门戈一
麋	鹿米
麒	鹿
苁	艹人人
摁	扌因心
涔	氵山㇆
宥	宀⺝
妍	女一廾
铤	钅壬廴
锷	钅吅丂
嗲	口八夕
恽	忄冖车
麂	鹿几
赝	厂亻贝
胛	月甲
哂	口西
撷	扌士页
呶	口女又
噘	口厂欠
懔	忄亠示
栎	木小
桎	木至
霰	⻗龷攵
飨	乡食
揄	扌亼刂
噔	口癶豆
娣	女丷
薏	艹音心
忝	一大⺗
咤	口宀七
嗵	口龴辶
迤	也辶
贲	十艹贝
胪	月卜尸
鍪	予丿金
泸	氵卜尸
蔫	艹一灬
刈	乂刂
僖	亻壴口
咿	口亻丿
鹌	大日鸟
嗪	口禾
茏	艹龙
茯	艹亻犬
岫	山由
嵘	山木
轱	古
怼	又寸心
铨	钅人王
昕	日斤
郢	口王阝
咩	口羊
馊	饣臼又
髡	髟兀
澧	氵曲豆
苣	艹匚コ
濯	氵羽隹
盥	水皿
囡	囗女
砺	石厂
佘	人示
谶	讠人一
弑	㐅朩工
楂	木木旦
翦	䒑⺝羽
怩	忄尸匕
蠼	虫目又
霏	⻗非
楹	木乃皿
讴	讠匸㐅
锲	钅丰大
慵	忄广
胝	月丶
砭	石丿之
潍	氵纟隹
杵	木十
樾	木走戉
帼	巾囗丶
碣	石曰亾
诌	讠⺈彐
徕	彳一米
胴	月冂
钴	钅古
裟	氵小
啶	口宀疋
铣	钅⺧儿
铱	钅衣
楫	木口耳
赭	土日
碛	石龶贝
酊	酉丁
魑	鬼文厶
醛	酉艹王
剐	口冂刂
畦	田土土
陂	阝皮
闶	门亠几
阄	门⺈乚
祚	礻乍
鹘	骨鸟
泱	氵大
趄	走且
骅	马亻十
陲	阝千二
郧	口贝阝
倜	亻⺆口
呤	口亽龴
燧	火丷辶
铉	钅亠幺
粲	歺又米
骶	骨丶
峁	山卯
忸	忄丑
渌	氵氺
骞	𡨄马
髭	髟止匕
戡	戈
钨	钅乌
谲	讠予口
苋	艹见
锃	钅口王
蜊	虫禾刂
幄	巾尸至
闼	门大辶
戕	爿戈
骊	马一
虢	爫寸虎
烩	火人云
傥	亻儿
妲	女旦
绌	纟屮凵
桠	木一业
袈	力口衣
薮	艹米攵
揿	扌钅欠
杲	日木
肓	亡⺝
厝	厂龷日
莅	艹亻立
氤	气因
缙	纟一日
衮	六厶
诟	讠
旖	方可
硒	石西
唁	口言
嬗	女亠旦
硎	石一刂
裱	衤龶
颦	止十
靥	厂犬面
纥	纟乙
煨	火田
礴	石艹寸
鏖	鹿金
蝈	虫囗丶
笏	⺮勹
羿	羽廾
鼐	乃目
湟	氵白王
甑	曰瓦
炜	火韦
煲	亻口火
锉	钅人土
笕	⺮见
喑	口音
嶂	山音十
浔	氵彐寸
弭	弓耳
妪	女匚乂
锂	钅里
苡	艹人
孳	䒑幺子
颏	亥页
醴	酉曲豆
渚	氵耂日
轭	车厂㔾
鹬	予丿鸟
蚝	虫毛
膘	月覀示
邛	工阝
痨	疒力
褡	衤艹口
耦	耒禺
覃	覀日十
馔	饣巳八
篾	⺮罒丶
兖	六厶儿
阋	门臼儿
遨	龶辶
爰	爫一又
痂	疒力口
艄	舟⺌⺝
耨	耒辰寸
沤	氵匸㐅
邋	巛辶
焓	火亽口
秣	禾一木
昶	丶日
窣	穴亠十
绦	纟夂木
俎	人人且
榫	木隹十
蟪	虫惠心
稗	禾十
謇	𡨄言
氩	气一业
锴	钅匕白
龉	齿五口
烃	火ス工
俣	亻口大
嬷	女麻厶
肱	月厶
鸢	弋鸟
笫	⺮𠂔
痤	疒人土
菏	艹氵可
莆	艹甫
芨	艹乃丶
阕	门癶大
砣	石宀匕
碜	石厶彡
鼹	鼠日女
猷	丷酉犬
竽	⺮一
舸	舟可
诓	讠匚王
錾	车斤金
淬	氵亠十
隗	阝鬼
悌	忄丷
姘	女䒑廾
槭	木戊小
邈	豸白辶
婕	女一龰
歙	亼口欠
稹	禾十
蹴	⻊尤
砒	石匕匕
痈	疒用
镏	钅田
羯	⺶曰亾
豕	豕丶
鲂	鱼方
蓖	艹匕
匦	匚车九
笤	⺮刀口
峥	山⺈
徭	彳爫缶
浃	氵一大
烊	火羊
窸	穴丿心
酆	山丰阝
缢	纟䒑皿
褓	衤亻木
蚨	虫夫
翳	匚矢羽
趔	走歹刂
炔	火人
誊	言
赜	龶贝
仃	亻丁
勖	⺜目力
葺	艹口耳
蚴	虫幺力
泷	氵龙
蛴	虫文
媸	女屮虫
俳	亻非
诖	讠土土
茑	艹鸟
逡	厶八辶
孱	尸子子
砦	止匕石
跸	⻊匕十
祜	礻古
伉	亻亠几
溴	氵自犬
屐	尸彳又
飚	⺇乂火
蛞	虫舌
掮	扌户⺝
崆	山穴工
庾	广臼人
橛	木厂欠
矸	石干
鸨	匕十鸟
圻	土斤
缂	纟革
蒯	艹月刂
诹	讠耳又
啭	口车丶
饧	饣ㄋ
镉	钅鬲
鸪	古鸟
蛩	工几虫
蠖	虫艹又
劭	刀口力
哐	口匚王
崧	山木厶
杼	木予
棂	木彐火
螫	土虫
龃	齿且
饔	亠乡食
遑	白王辶
颢	日页
腱	月聿廴
襁	衤弓虫
忾	忄气
濠	氵豕
牝	牜匕
蛄	虫古
鲆	鱼干丷
嗄	口丆夂
灏	氵日页
疥	疒人
苜	艹目
荞	艹丿
嘣	口山月
夤	夕宀八
砝	石土厶
颞	耳又页
忤	忄十
遢	⺜羽辶
旎	方匕
瘛	疒丰心
魉	鬼𰀃人
辇	夫夫车
瓤	亠吅瓜
荥	水
涫	氵宀㠯
娌	女里
氚	气川
臁	月广兼
毂	车殳
碇	石宀疋
毖	匕匕丿
壅	亠乡土
吡	口匕匕
缛	纟辰寸
玮	王韦
羟	⺶ス工
珈	王力口
颀	斤页
虼	虫乙
祇	礻七
佝	亻句
翕	亼口羽
遴	米夕辶
珏	王王丶
郛	爫子阝
玖	王㇏
蹇	𡨄足
逋	甫辶
氅	尚攵毛
粽	米宀示
诂	讠古
岢	山可
聒	耳舌
髁	骨日木
黍	禾人氺
芾	艹一巾
淝	氵月巴
鲎	⺍冖鱼
鞣	革予木
髋	骨宀见
闳	门厶
潆	氵糸
汨	氵日
胍	月瓜
阏	门方⺀
钤	钅亽㇆
鹜	予丿鸟
鬈	髟㔾
铵	钅宀女
戬	一业戈
崮	山囗古
枰	木干丷
樯	木十口
脍	月人云
畲	人示田
衾	亽㇆衣
蹼	⻊业夫
劬	句力
咭	口士口
囫	囗勹
洱	氵耳
刎	勹刂
芏	艹土
琊	王牙阝
碚	石立口
鳕	鱼⻗彐
谪	讠古
芎	艹弓
恂	忄勹日
槿	木革二
鲢	鱼车辶
鲧	鱼丿糸
嘧	口宀山
绀	纟甘
郦	一阝
噱	口虍豕
浠	氵㐅巾
潸	氵木⺝
跏	⻊力口
鲶	鱼亽心
矍	目目又
苌	艹长
抻	扌申
琰	王火火
鹚	䒑幺鸟
龆	齿刀口
臬	自木
芄	艹丸
呔	口大丶
雒	夂口隹
觞	⺈用
钒	钅几丶
饫	饣丿大
阒	门目犬
槎	木⺶工
鸩	冖儿鸟
舂	臼
谠	讠儿
阡	阝千
莒	艹口口
萸	艹臼人
妗	女亽㇆
稔	禾亽心
穰	禾亠
蚧	虫人
餍	厂犬食
谯	讠隹灬
芗	艹乡
菸	艹方⺀
葩	艹白巴
踔	⻊卜十
厣	厂犬甲
佻	亻儿
嘌	口覀示
饩	饣气
钏	钅川
蠓	虫豕
黩	黑十大
倨	亻尸古
缬	纟士页
殚	歹丷十
钿	钅田
鎏	氵金
恁	亻壬心
藿	艹⻗隹
囟	㐅一
鄣	音十阝
呋	口夫
婺	予丿女
绱	纟尚
瓯	匸㐅瓦
旃	方亠
锶	钅田心
酩	酉夕口
恹	忄厂犬
逶	禾女辶
缦	纟曰又
鸹	舌鸟
螟	虫冖六
菟	艹兔
阗	门十
濉	氵目隹
篑	⺮贝
醪	酉羽彡
鲛	鱼六乂
讦	讠干
媪	女日皿
邬	乌阝
殇	歹
鄯	羊䒑阝
芡	艹欠
嫠	未攵女
肼	月井
峤	山丿
矽	石夕
讧	讠工
掼	扌毌贝
焖	火门心
愆	彳氵心
聩	耳贝
岘	山见
靛	龶⺝疋
菖	䒤曰
卟	口卜
姒	女人
杷	木巴
砉	丰石
袢	衤丷
蚋	虫冂人
笳	⺮力口
挈	丰刀手
踽	⻊丿冂
黾	黾ㄋ
侩	亻人云
凫	几
诔	讠耒
郯	火火阝
韪	日韦
挲	氵小手
笪	旦
鼋	一兀黾
莜	艹攵
菅	艹宀㠯
嵊	山禾匕
裢	衤车辶
趿	⻊乃丶
箸	⺮耂日
莴	艹口人
莠	艹禾乃
阌	门又
旯	日九
圜	囗罒
涪	氵立口
赍	十人贝
柞	木乍
嗍	口䒑月
囵	囗人匕
榧	木匚非
裰	衤又又
笾	⺮力辶
簟	⺮覀十
跎	⻊宀匕
巽	巳巳八
曷	曰勹亾
逖	犭火辶
骓	马隹
绔	纟大丂
枋	木方
镒	钅䒑皿
魃	鬼丶
餮	歹人食
讵	讠匚コ
乜	㇆乚ㄋ
鄢	一止阝
瑭	王广口
踅	扌斤足
馓	饣龷攵
蟛	虫壴彡
鳟	鱼丷寸
荛	艹兀
忪	忄八厶
阍	门日
姹	女宀七
纰	纟匕匕
桉	木宀女
氪	气古儿
氘	气
垅	土龙
郃	亼口阝
汊	氵又丶
娉	女由丂
纡	纟一
缟	纟高
旮	九日
镢	钅厂欠
傈	亻覀木
堋	土月月
蔺	艹门隹
庥	广亻木
枥	木厂力
腭	月吅丂
鹕	古月鸟
笮	⺮乍
髂	骨宀口
魍	鬼冂亡
缁	纟巛田
槊	䒑木
跞	⻊小
醚	酉米辶
吒	口丿七
枳	木口八
搿	手亼手
鹧	广廿鸟
蜍	虫亼朩
舻	舟卜尸
鏊	龶金
禳	礻亠
蒺	艹疒矢
钹	钅丶
蜢	虫子皿
鬻	弓米鬲
珩	王彳亍
卮	⺁一㔾
垭	土一业
苄	艹亠卜
苕	艹刀口
菀	艹宀㔾
骠	马覀示
袷	衤亼口
跹	⻊千辶
瘘	疒米女
磬	士石
缶	缶丨
笸	⺮匚口
鸷	扌丸鸟
芰	艹十又
蕲	艹丷斤
阆	门丶艮
纨	纟丸
琮	王宀示
牦	牜毛
砩	石弓
蠲	䒑八虫
锒	钅丶艮
锕	钅阝可
郓	冖车阝
妯	女由
驷	马四
鹩	大丷鸟
舢	舟山
趸	一足
芫	艹一兀
嗉	口龶糸
蠊	虫广兼
笊	⺮爪
莸	艹犭尤
饴	饣厶口
阃	门囗木
浯	氵五口
枇	木匕匕
焱	火火火
铆	钅卯
擤	扌自丌
柢	木丶
醢	酉皿
呲	口止匕
崾	山覀女
溆	氵亼又
潴	氵犭日
牖	片户甫
硪	石手戈
碓	石隹
鹆	谷鸟
鬣	髟巛
堀	土尸凵
帙	巾丿夫
雱	⻗方
诎	讠屮凵
獐	犭音十
桁	木彳亍
蛱	虫一大
鳏	鱼罒
郴	木木阝
幂	冖日巾
箝	⺮扌甘
僳	亻覀米
疝	疒山
茴	艹囗口
揶	扌耳阝
呦	口幺力
嗌	口䒑皿
囹	囗亽龴
螈	虫厂小
脲	月尸水
镊	钅耳又
锑	钅丷
胨	月小
膈	月鬲
痼	疒囗古
鳊	鱼户
赅	贝亥
贽	扌丸贝
苤	艹不一
峄	山又
桡	木兀
雎	且隹
鲋	鱼亻寸
鞫	革勹言
鼬	鼠由
獯	犭千黑
昀	日勹冫
痍	疒一人
蟊	予丿虫
鞴	革龷
疖	疒卩
熘	火田
乇	丿七
羸	赢羊
嵴	山冫⺝
栀	木⺁㔾
槲	木⺈十
炝	火人㔾
炷	火丶王
硐	石冂
锸	钅千臼
鹂	一鸟
裾	衤尸古
侪	亻文
珐	王土厶
哔	口匕十
屙	尸阝可
旆	方巾
佰	亻丆日
僦	亻尤
牯	牜古
钪	钅亠几
掾	扌彑
仟	亻千
圮	土己
芟	艹殳
崃	山一米
廪	广亠示
擘	尸口手
笱	⺮句
跗	⻊亻寸
鲅	鱼丶
硷	石亼一
苎	艹宀一
匏	大一巳
嗾	口方矢
圄	囗五口
彀	一殳
粳	米一
卣	卜囗コ
勐	子皿力
掴	扌囗丶
涑	氵束
浞	氵足
玳	王亻弋
愍	民攵心
畛	田人彡
赧	土又
貉	豸夂口
擀	扌十干
湫	氵禾火
逦	一辶
椴	木殳
铄	钅小
箧	⺮匚大
刖	月刂
鲮	鱼土夊
訇	勹言
茱	艹丿未
啖	口火火
悭	忄〢土
愀	忄禾火
朐	月句
畈	田⺁又
鹨	羽人鸟
蛘	虫羊
佶	亻士口
缃	纟木目
晟	日戊㇆
鲱	鱼非
凼	水凵
苴	艹且
颛	山而页
厍	厂车
徉	彳羊
洙	氵丿未
氡	气夂⺀
胗	月人彡
癯	疒目隹
鞒	革丿
锆	钅⺧口
佤	亻瓦
勰	力力心
钺	钅戉
繇	爫缶糸
螭	虫文厶
嵬	山鬼
轸	人彡
肟	月一丂
肫	月一
邨	一阝
瘿	疒贝女
仞	亻刀丶
奁	大匸㐅
宄	宀九
轳	车卜尸
熳	火曰又
睇	目丷
钼	钅目
蝼	虫米女
跆	⻊厶口
樗	木雨丂
鲰	鱼耳又
诶	讠厶矢
薜	艹尸辛
铧	钅亻十
裥	衤门日
榇	木立木
馃	饣日木
蹚	⻊土
怄	忄匸㐅
寤	宀爿口
缗	纟民日
硗	石兀
碡	石龶母
矬	矢人土
鸱	七鸟
虺	兀虫
糅	米予木
雠	隹讠隹
帑	女又巾
镧	钅门丷
埙	土口贝
啁	口⺆口
悒	忄口巴
犍	牜聿廴
硌	石夂口
锩	钅
虿	一虫
蛑	虫厶牛
艉	舟尸毛
咴	口火
筮	⺮工人
艏	舟䒑自
糁	米厶彡
鼍	吅田黾
肄	匕矢聿
籴	入米
骜	龶马
砻	龙石
蜮	虫戈一
龀	齿匕
黢	黑厶夂
劢	一力
耪	耒方
鬯	凵匕
畚	厶大田
觳	一殳
稞	禾日木
鹁	子鸟
鲲	鱼日匕
捌	扌口刂
菔	艹月又
獬	犭⺈牛
柘	木石
娆	女兀
篪	⺮⺁虎
鲀	鱼一
谰	讠门丷
孬	不女子
伥	亻长
谇	讠亠十
鄄	覀土阝
狎	犭甲
闫	门三
滟	氵丰巴
齑	文一
遒	丷酉辶
磔	石夕木
聃	耳冉
綦	糸
鲡	鱼一
蔻	艹宀攴
泠	氵亽龴
砗	石车
钕	钅女
镫	钅癶豆
菹	艹氵且
胂	月申
煅	火殳
煸	火户
螯	龶虫
躅	⻊罒虫
鲠	鱼一
佥	亼⺍一
罘	罒不
嶝	山癶豆
坨	土宀匕
菽	艹上又
哞	口厶牛
徜	彳尚
慊	忄兼
洳	氵女口
渑	氵黾
灞	氵⻗月
盍	土厶皿
钋	钅卜
鸫	小鸟
踯	⻊䒑阝
縻	麻糸
萘	艹大示
褫	衤⺁虎
羰	⺶山火
俅	亻一丶
芤	艹子乚
隳	阝⺗
洮	氵儿
胼	月䒑廾
罴	罒土灬
镛	钅广
怛	忄旦
芊	艹千
啉	口木木
噌	口曰
嫱	女十口
绲	纟日匕
膻	月亠旦
焐	火五口
葎	艹彳聿
亓	一丌
倮	亻日木
莼	艹纟
蘅	艹彳亍
嘞	口革力
缒	纟丿辶
镆	钅䒤大
伧	亻人㔾
荏	艹亻壬
唳	口户犬
檩	木亠示
鸶	纟纟鸟
蚬	虫见
骱	骨人
蘖	艹丿木
澍	氵壴寸
韫	韦日皿
颎	匕火页
嘏	古又
垡	亻戈土
腚	月宀疋
焯	火卜十
怙	忄古
羧	⺶厶夊
鼙	壴十十
倥	亻穴工
亳	丿七
艽	艹九
荠	艹文
昴	日卯
舨	舟⺁又
魈	鬼⺌⺝
醣	酉广口
枵	木口丂
粜	屮凵米
甙	弋甘
珲	王冖车
杓	木勹丶
楸	木禾火
楦	木宀旦
疃	田立里
蛏	虫又土
蠛	虫艹丶
髌	骨宀
茔	土
诼	讠豕丶
嬖	尸口女
蜣	虫⺶乚
笄	⺮一廾
跣	⻊⺧儿
钣	钅⺁又
戆	音十心
蜉	虫爫子
喾	⺍冖口
铍	钅皮
陉	阝ス工
薹	艹士至
肷	月欠
岵	山古
瓴	亽龴瓦
荽	艹爫女
怫	忄弓
钭	钅⺀十
窀	穴一
缯	纟曰
倬	亻卜十
摭	扌广灬
帔	巾皮
楝	木束丷
痱	疒非
蚶	虫甘
螬	虫一曰
髑	骨罒虫
鼗	儿冫又
狷	犭口⺝
殛	歹了一
裉	衤艮
粝	米厂
萋	艹一女
葭	艹又
衽	衤壬
鳢	鱼曲豆
傧	亻宀
喁	口禺
嫘	女田糸
罟	罒古
钌	钅了
裼	衤日
愦	忄贝
蝽	虫日
锗	钅耂日
衿	衤亽㇆
粢	冫欠米
醵	酉虍豕
跫	工几足
鐾	尸口金
廛	广里土
墉	土广
哌	口⺁
扦	扌千
堇	革二
婧	女龶⺝
暌	日癶大
罱	罒十
镞	钅方矢
蹰	⻊厂寸
陟	阝止
鳔	鱼覀示
脘	月宀兀
岿	山彐
侔	亻厶牛
郾	匚日阝
唿	口勹心
砹	石艹乂
疴	疒可
麸	龶夂夫
薨	艹罒匕
滁	氵阝朩
偾	亻十贝
拊	扌亻寸
撺	扌穴丨
呒	口无
狯	犭人云
猢	犭古月
椁	木子
榱	木亠
罾	罒曰
铳	钅儿
裎	衤口王
鳚	鱼尸寸
眦	目止匕
璎	王贝女
崞	山子
缇	纟日
蝣	虫方子
萑	艹隹
狲	犭子小
缱	纟辶
晷	日夂口
冼	冫⺧儿
痧	疒氵丿
蕖	艹氵木
狍	犭勹巳
憷	忄木疋
锛	钅大廾
窨	穴音
袼	衤夂口
帏	巾韦
儋	亻⺈言
绨	纟丷
疠	疒一
蘩	艹糸
嵝	山米女
庀	广匕
汜	氵巳
炅	日火
煳	火古月
泶	⺍冖水
瓠	大一瓜
窳	穴瓜瓜
虮	虫几
蚰	虫由
邰	厶口阝
苊	艹厂㔾
砀	石ㄋ
捩	扌户犬
蹉	⻊⺶工
莪	艹手戈
螽	夂⺀虫
蘼	艹麻非
槔	木白十
曛	日千黑
蛲	虫兀
鹾	卜囗工
隹	隹一
犸	犭马
衄	丿皿丑
銎	工几金
泫	氵亠幺
玢	王八刀
辊	日匕
瞋	目十
墀	土尸牛
酐	酉干
堞	土廿木
尥	尢勹丶
嚯	口⻗隹
猗	犭大可
逑	一水辶
逯	氺辶
硖	石一大
噻	口𡨄土
嵛	山亼刂
畀	田丌
鲃	鱼巴
偬	亻勹心
鄞	革二阝
呖	口厂力
溧	氵覀木
嬲	田力力
肭	月冂人
鹈	丷𢎨鸟
鹱	鸟艹又
窭	穴米女
黧	禾勹黑
谵	讠⺈言
沆	氵亠几
嫒	女又
塬	土厂小
缣	纟兼
篯	钅戋
酃	⻗吅阝
喱	口厂里
泔	氵甘
溘	氵土皿
迕	十辶
秫	禾木丶
裣	衤亼一
铋	钅心丿
蒌	艹米女
曩	日亠
赀	止匕贝
箪	竹丷十
朊	月一兀
鳙	鱼广
仫	亻丿厶
钎	钅千
芑	艹己
胙	月乍
盱	目一
糇	米亻矢
挹	扌口巴
捭	扌十
悱	忄非
鬟	髟罒
崤	山㐅⺝
澶	氵亠旦
甾	巛田
欹	大可欠
瞽	壴十目
钇	钅乙ㄋ
鹪	隹灬鸟
鞔	革
缡	纟文厶
铯	钅⺈巴
鲚	鱼文
嘬	口曰又
庹	广廿㇏
渖	氵宀申
湔	氵䒑刂
玎	王丁
锜	钅大可
锊	钅爫寸
舾	舟西
籼	米山
阊	门日曰
祕	礻心丿
猊	犭臼儿
燹	豕豕火
葑	艹土寸
蓼	艹羽彡
幛	巾音十
岣	山句
浼	氵
甯	宀心
瑷	王又
敫	白方攵
钔	钅门
钫	钅方
锼	钅臼又
锿	钅
癔	疒音心
穸	穴夕
褊	衤户
蚍	虫匕匕
篦	匕
麇	鹿禾
樘	木土
钯	钅巴
铒	钅耳
莩	艹爫子
嵯	山⺶工
逭	宀㠯辶
遄	山而辶
戗	人㔾戈
睃	目厶夊
瀣	氵歺一
皴	厶八皮
泮	氵丷
轫	刀丶
褰	𡨄衣
炱	厶口火
醍	酉日
锱	钅巛田
篁	⺮白王
葚	艹㇗
驽	女又马
辚	米㐄
睥	目十
鸺	亻木鸟
筇	⺮工阝
戥	日生戈
髀	骨十
驺	马⺈彐
哙	口人云
濞	氵自丌
逄	夂㐄辶
桤	木山己
炻	火石
磙	石六
疳	疒甘
醭	酉业夫
鳇	鱼白王
鹮	罒鸟
迓	牙辶
眇	目小丿
楮	木耂日
砜	石⺇乂
菘	艹木厶
馇	饣木旦
栌	木卜尸
醐	酉古月
唢	口⺌贝
獍	犭音儿
殳	殳丶
仡	亻乙
刿	山夕刂
葜	艹丰大
薅	艹女寸
湓	氵八皿
搴	𡨄手
尕	乃小
磴	石癶豆
锝	钅旦寸
镅	钅目
艚	舟一曰
殄	歹人彡
暝	日冖六
祢	礻⺈小
豉	豆十又
垴	土文凵
瓿	立口瓦
煺	火艮辶
蟥	虫龷八
蹀	⻊廿木
黼	业㡀甫
氙	气山
铑	钅耂匕
蒡	艹方
杪	木小丿
肜	月彡
膂	方⺝
砬	石立
硭	石艹亡
酽	酉一丿
踟	⻊矢口
鲷	鱼⺆口
蒴	艹䒑月
藁	艹高木
猡	犭罒夕
旒	方
硇	石一
锍	钅
鞲	革冉
哿	力口可
皤	白丿田
哏	口艮
殍	歹爫子
漯	氵田糸
谂	讠亽心
跶	⻊大辶
橥	犭耂木
镬	钅艹又
鸲	句鸟
姝	女丿未
茭	艹六乂
窆	穴丿之
髟	髟丿
畋	田攵
溏	氵广口
鲔	鱼⺝
喹	口大土
吣	口心
羼	尸羊羊
缧	纟田糸
窬	穴亼刂
骘	阝止马
赉	一米贝
镓	钅宀豕
邳	不一阝
璩	王虍豕
鸸	而鸟
涠	氵囗韦
溲	氵臼又
孥	女又子
敉	米攵
筌	⺮人王
垓	土亥
苒	艹冉
荸	艹子
甓	尸口瓦
锪	钅勹心
镄	钅弓贝
脔	亦冂人
艟	舟立里
眬	目龙
彘	彑匕匕
檠	艹句木
胩	月上卜
旄	方毛
祆	礻一大
鲻	鱼巛田
腈	月龶⺝
沭	氵木丶
垸	土宀兀
邡	方阝
秭	禾𠂔
耋	耂匕至
仉	亻几
坻	土丶
滹	氵虍
砼	石人工
郗	㐅阝
岙	丿大山
埭	土彐水
蓥	金
阚	门乛攵
岜	山巴
叻	口力
爿	爿丿
珉	王民
郜	⺧口阝
怿	忄又
绂	纟丶
骝	马田
邗	干阝
骐	马
箐	⺮龶⺝
镗	钅土
眙	目厶口
坭	土尸匕
埕	土口王
沔	氵一㇆
孑	了一一
埝	土亽心
唛	口龶夂
鳜	鱼厂欠
隰	阝日灬
塍	月土
昝	夂卜日
蕤	艹豕生
茌	艹亻士
鲳	鱼日曰
琚	王尸古
垧	土口
仝	人工
囗	囗一
镝	钅古
樨	木尸牛
黟	黑夕夕
訾	止匕言
珙	王龷八
耒	耒丶
铌	钅尸匕
葳	艹戊女
觇	卜口见
碲	石巾
椐	木尸古
屺	山己
蓊	艹八羽
荦	牛
糌	米夂日
砘	石一
蕻	艹镸八
瑗	王爫又
郇	勹日阝
毽	毛聿廴
菡	艹乛凵
栲	木耂丂
圹	土广
潋	氵亼攵
鲵	鱼臼儿
筚	⺮匕十
棰	木千二
滏	氵八䒑
仵	亻十
獒	龶犬
豇	豆工
莨	艹丶艮
眭	目土土
妤	女予
瘐	疒臼人
绐	纟厶口
桷	木⺈用
掊	扌立口
茕	⺄十
柁	木宀匕
嶷	山匕疋
趵	⻊勹丶
蔸	艹白儿
霈	⻗氵巾
淠	氵田丌
柒	氵七木
辋	冂亡
郄	㐅阝
殪	歹豆
翥	耂日羽
檗	尸口木
柽	木又土
菪	艹宀石
戢	口耳戈
尻	尸九
贶	贝口儿
揠	扌匚女
缍	纟千二
锇	钅手戈
浍	氵人云
垲	土山己
郐	人云阝
嫫	女䒤大
溱	氵禾
箬	⺮艹口
钽	钅旦
蓁	艹禾
褙	衤⺝
邴	𰀃人阝
铖	钅戊㇆
坜	土厂力
溽	氵辰寸
暾	日攵
崦	山大乚
荑	艹一人
棼	木木刀
耧	耒米女
铙	钅兀
郫	十阝
汔	氵乙
钐	钅彡
腧	月亼刂
坼	土斤丶
糍	米䒑幺
骢	马心
绋	纟弓
钆	钅乚ㄋ
菰	艹子瓜
埚	土口人
绗	纟彳亍
蒗	艹氵艮
莳	艹日寸
鲐	鱼厶口
氽	人水
芴	艹勹
箦	⺮龶贝
钲	钅一止
缵	纟⺧贝
瘳	疒羽彡
亍	亍丨
垌	土冂
椟	木十大
桴	木爫子
赙	贝甫寸
坩	土甘
臌	月壴又
跽	⻊己心
猁	犭禾刂
埤	土十
鲭	鱼龶⺝
猞	犭亼古
眚	生目
铈	钅亠巾
耜	耒㠯
鹇	门木鸟
鲞	鱼
镱	钅音心
铟	钅因
镔	钅宀
酲	酉口王
茺	艹儿
旰	日干
徼	彳白攵
孓	了丶丶
侉	亻大丂
夼	大川
跬	⻊土土
铼	钅一米
茆	艹卯
蹁	⻊户
綮	户攵糸
犰	犭九
铷	钅女口
筲	⺮⺌⺝
铊	钅宀匕
屣	尸彳龰
哓	口兀
铕	钅⺝
豸	豸丿
趑	走冫欠
秕	禾匕匕
荜	艹匕十
镲	钅宀示
镦	钅攵
鬲	鬲丨
铪	钅亼口
鲩	鱼宀兀
牮	亻弋牛
礓	石一一
氇	毛鱼日
镙	钅田糸
柰	木示
氆	毛䒑日
鲥	鱼日寸
桫	木氵丿
铽	钅弋心
洧	氵⺝
绡	纟⺌⺝
洫	氵丿皿
洇	氵因
吖	口丷丨
埯	土大乚
妣	女匕匕
飑	⺇乂巳
豳	山豕豕
蔟	艹方矢
毳	毛毛毛
疔	疒丁
顸	干页
翮	鬲羽
廑	广革二
醌	酉日匕
蝥	予丿虫
醅	酉立口
芘	艹匕匕
榀	木口吅
萁	艹
苘	艹冂口
剡	火火刂
椹	木㇗
酞	酉大丶
葶	艹丁
葸	艹田心
狺	犭言
雩	雨一丂
橼	木纟
怍	忄乍
檫	木宀示
殂	歹且
纛	龶母糸
鼢	鼠八刀
缑	纟亻矢
戽	户⺀十
瘕	疒又
枧	木见
洚	氵夂㐄
桕	木臼
剀	山己刂
瘌	疒束刂
鳓	鱼革力
蓠	艹文厶
埒	土爫寸
瘰	疒田糸
镘	钅曰又
脒	月米
腩	月十
筢	⺮扌巴
巯	ス工
悫	几心
蛸	虫⺌⺝
毹	亼⺝毛
妁	女勹丶
沩	氵丶丶
鼯	鼠五口
牾	牜五口
蕈	艹覀十
吲	口弓丨
舴	舟乍
棹	木卜十
甏	壴彡瓦
箅	⺮田丌
晡	日甫
礅	石攵
蒽	艹因心
绠	纟一
觚	⺈用瓜
颃	亠几页
篌	⺮亻矢
铗	钅一大
赆	贝尸⺀
皲	冖车皮
佧	亻上卜
箜	⺮穴工
蒉	艹贝
酹	酉爫寸
疬	疒厂力
膦	月米㐄
泺	氵小
荬	艹乛大
颟	艹𰀃页
泖	氵卯
耱	耒麻石
襻	衤木手
蘧	艹虍辶
氍	目目毛
酾	酉一
锬	钅火火
髫	髟刀口
萜	艹巾口
堍	土兔
璺	冂丶
怃	忄无
睚	目厂土
痖	疒一业
瘗	疒一土
圉	囗土
砟	石乍
轵	口八
廒	广龶攵
聱	龶耳
庳	广十
腠	月大
铥	钅壬厶
沲	氵也
簋	⺮艮皿
蚵	虫可
癀	疒龷八
钬	钅火
掎	扌大可
鲣	鱼〢土
囝	囗子
踺	⻊聿廴
茳	艹氵工
糨	米弓虫
刳	大一刂
悃	忄囗木
墚	土氵木
柃	木亽龴
镥	钅鱼日
杩	木马
墁	土曰又
玟	王文
蝻	虫十
搦	扌弓冫
蜱	虫十
俜	亻由丂
镨	钅䒑日
镪	钅弓虫
枘	木冂人
埏	土丿廴
溻	氵⺜羽
酡	酉宀匕
圬	土一丂
粞	米西
觋	工人见
莶	艹亼一
榍	木尸⺝
薤	艹歹一
髹	髟亻木
疋	疋丶
佾	亻八⺝
埸	土日
霪	⻗氵壬
茚	艹卩
伛	亻匸㐅
瘵	疒示
骣	马尸子
轾	车至
邾	丿未阝
槠	木讠日
嵫	山䒑幺
蕞	䒤耳又
犴	犭干
滗	氵⺮毛
耖	耒小丿
彳	彳丨
茈	艹止匕
璁	王心
爨	冂火
萏	艹⺈臼
坫	土卜口
篼	⺮白儿
簖	⺮米斤
哚	口几木
蹯	⻊丿田
瀵	氵米八
陔	阝亥
筻	⺮一
廾	廾丨
蜾	虫日木
黉	⺍冖八
骺	骨
冱	冫一彑
漶	氵口心
耠	耒亼口
搛	扌兼
鹣	兼鸟
僬	亻隹灬
噍	口隹灬
纩	纟广
栝	木舌
稂	禾丶艮
塄	土罒方
躐	⻊巛
簏	⺮鹿
脶	月口人
瞀	予丿目
艨	舟豕
芈	卝
糸	糸丶
眄	目一㇆
鹋	艹田鸟
瘼	疒䒤大
猱	犭予木
脬	月爫子
貔	豸匕
仳	亻匕匕
犏	牜户
锓	钅彐又
蚺	虫冉
潲	氵禾⺝
埘	土日寸
缌	纟田心
澌	氵斤
蔌	艹束欠
梃	木壬廴
彖	彑
隈	阝田
痦	疒五口
欷	㐅欠
鼷	鼠爫大
痃	疒亠幺
碹	石宀旦
谳	讠十犬
轺	刀口
铘	钅牙阝
圯	土巳
蓣	艹予页
瀹	氵亼
趱	走⺧贝
驵	马且
揸	扌木旦
絷	扌丸糸
跖	⻊石
舯	舟口丨
籀	⺮扌田
舳	舟由
陬	阝耳又
阼	阝乍
揞	扌音
菝	艹扌丶
癍	疒王王
鹎	十鸟
坌	八刀土
狴	犭匕土
萆	艹十
襞	尸口
碥	石户
瘥	疒⺶工
惝	忄尚
怊	忄刀口
帱	巾寸
徂	彳且
汆	入水
脞	月人土
瘅	疒丷十
忉	忄刀
羝	⺶丶
瓞	瓜丿夫
鲽	鱼廿木
岽	山小
佴	亻耳
稃	禾爫子
幞	巾业夫
澉	氵乛攵
茛	艹艮
觏	冉见
酤	酉古
牿	牜⺧口
鲴	鱼囗古
呙	口冂人
馘	䒑自一
瘊	疒亻矢
虍	虍ㄋ
缋	纟贝
溷	氵囗豕
剞	大可刂
洎	氵自
恝	丰刀心
蒹	艹兼
谫	讠䒑刀
挢	扌丿
卺	乛水㔾
扃	户冂口
锔	钅尸口
觖	⺈用人
劂	厂䒑刂
骒	马日木
悝	忄里
蝰	虫大土
苈	艹厂力
篥	⺮覀木
娈	亦女
瞵	目米㐄
栊	木龙
癃	疒阝生
辂	车夂口
稆	禾口口
甍	艹罒瓦
艋	舟子皿
镎	钅亼手
陧	阝日土
锘	钅艹口
擗	扌尸辛
螵	虫覀示
钷	钅匚口
攴	攴丶
凵	凵丨
锖	钅龶⺝
黥	黑小
蝤	虫丷酉
悛	忄厶夊
辁	人王
颡	又又页
摅	扌虍心
骀	马厶口
螗	虫广口
耥	耒尚
铫	钅儿
莛	艹壬廴
箨	⺮扌
蕹	艹亠隹
杌	木兀
舄	臼勹灬
禊	礻丰大
猃	犭亼一
绁	纟廿㇗
渫	氵廿木
廨	广⺈牛
荇	艹彳亍
貅	豸亻木
糈	米疋⺝
揎	扌宀旦
镟	钅方疋
罨	罒大乚
鳐	鱼爫缶
舣	舟丶乂
媵	月女
尢	尢ㄋ
侑	亻⺝
狳	犭亼朩
龠	亼吅
昃	日厂人
痄	疒乍
搌	扌尸
浈	氵卜贝
埴	土十一
黹	业㡀
酎	酉寸
茇	艹丶
邶	匕阝
舭	舟匕匕
忭	忄亠卜
缏	纟亻
瘭	疒覀示
踣	⻊立口
钸	钅巾
礤	石艹示
骖	马厶彡
黪	黑厶彡
猹	犭木旦
镡	钅覀十
躔	⻊广土
蒇	艹戊贝
冁	丷日
枨	木长
眵	目夕夕
傺	亻示
搋	扌⺁虎
舡	舟工
楱	木大
镩	钅穴丨
觌	十乛见
阽	阝卜口
铞	钅口巾
垤	土至
揲	扌廿木
耵	耳丁
憝	子心
鲕	鱼而
篚	⺮匚非
鲼	鱼十贝
唪	口
祓	礻丶
艴	弓巴
黻	业㡀丶
鳆	鱼夊
尜	小大小
戤	乃又戈
塥	土鬲
遘	冉辶
桄	木小兀
胲	月亥
撖	扌乛攵
嚆	口艹高
堠	土亻矢
烀	火丿
轷	丿
锾	钅爫又
缳	纟罒
擐	扌罒
哕	口山夕
劐	艹隹刂
攉	扌⻗隹
丌	丌丨
墼	車凵土
蕺	艹口戈
彐	彐一
哜	口文
戋	戋丶
趼	⻊一廾
楗	木聿廴
耩	耒冉
喈	口匕白
鲒	鱼士口
刭	ス工刂
弪	弓ス工
鬏	髟禾火
犋	牜
屦	尸彳女
桊	木
爝	火爫寸
捃	扌彐口
锎	钅门廾
蒈	艹匕白
莰	艹土欠
钶	钅可
锞	钅日木
眍	目匸㐅
筘	⺮扌口
漤	氵木女
铹	钅力
栳	木耂匕
耢	耒力
仂	亻力
泐	氵阝力
檑	木⻗田
轹	小
蔹	艹亼攵
垆	土卜尸
蠃	赢虫
漭	氵艹廾
猸	犭目
鹛	目鸟
瞢	艹罒目
礞	石豕
苠	艹民
鳘	母鱼
貊	豸丆日
貘	豸䒤大
毪	毛厶牛
坶	土母
攮	扌
聍	耳宀丁
狃	犭丑
胬	女又人
恧	而心
蒎	艹氵
锫	钅立口
陴	阝十
氕	气丿丿
裒	亠臼
镤	钅业夫
蜞	虫
岍	山一廾
椠	车斤木
劁	隹灬刂
缲	纟口木
檎	木人厶
螓	虫禾
圊	囗龶⺝
謦	士言
赇	贝一丶
鼽	自田九
糗	米自犬
麴	木人米
磲	石氵木
畎	田犬
狨	犭戈
蝾	虫木
薷	艹⻗而
襦	衤⻗而
颥	⻗而页
蓐	艹辰寸
脎	月㐅朩
毵	厶大毛
磉	石又木
鳋	鱼又虫
唼	口立女
歃	千臼欠
骟	马户羽
滠	氵耳又
矧	矢弓丨
蓍	艹耂日
鲺	鱼⺄虫
贳	廿㇗贝
搠	扌䒑月
兕	兀
螋	虫臼又
瞍	目臼又
觫	⺈用束
赕	贝火火
铴	钅氵
慝	匸艹心
掭	扌一⺗
祧	礻儿
蜩	虫⺆口
鲦	鱼夂木
茼	艹冂
酴	酉亼朩
柝	木斤丶
腽	月日皿
軎	車口
阢	阝兀
菥	艹木斤
蓰	艹彳龰
柙	木甲
筅	⺮⺧儿
葙	艹木目
蟓	虫象
躞	⻊言又
醑	酉疋⺝
儇	亻罒
岈	山牙
砑	石牙
珧	王儿
酏	酉也
劓	自田刂
堙	土覀土
撄	扌贝女
舁	臼廾
蝓	虫亼刂
燠	火大
眢	夕㔾目
箢	⺮宀㔾
狁	犭厶儿
拶	扌巛夕
唣	口白七
迮	乍辶
帻	巾龶贝
谮	讠旡曰
哳	口扌斤
齄	自田旦
膪	月口
嫜	女音十
忮	忄十又
膣	月穴至
踬	⻊⺁贝
荮	艹纟寸
瘃	疒豕丶
麈	鹿丶王
疰	疒丶王
禚	礻⺷灬
觜	止匕用
耔	耒子
腙	月宀示
鄹	耳又阝
躜	⻊⺧贝
撙	扌丷寸
鳒	鱼兼
啰	口罒夕
芠	艹文
惇	忄子
婠	女宀㠯
嫚	女曰又
扞	扌干
姮	女一旦
珅	王申
塆	土亦弓
珣	王勹日
濛	氵豕
玥	王月
珪	王土土
滘	氵冖口
垟	土羊
矞	予丿口
瑄	王宀旦
脩	夂⺝
傕	亻冖隹
珰	王彐
彧	戈口
秾	禾冖
晞	日㐅巾
嬛	女罒
嗐	口宀口
玕	王干
湜	氵日
棻	艹八木
炆	火文
鳉	鱼丬寸
纮	纟厶
蹓	⻊田
喆	士口口
槃	舟殳木
璟	王日小
屌	尸口巾
絜	丰刀糸
罍	田田缶
飏	⺇乂
鲙	鱼人云
颙	禺页
捽	扌亠十
幪	巾豕
湲	氵爫又
跂	⻊十又
磏	石兼
禛	礻十
磻	石丿田
燊	火火木
苾	艹心丿
藨	艹鹿灬
硚	石丿
鲉	鱼由
呣	口母
摽	扌覀示
骎	马彐又
縠	一殳
窅	穴目
旻	日文
玠	王人
翛	夂羽
瑱	王十
鸮	口丂鸟
崄	山亼一
浥	氵口巴
炘	火斤
犇	牛牛牛
碁	石
垱	彐
茀	艹弓
囷	囗禾
纻	纟宀一
鹢	䒑八鸟
烝	乛水灬
燋	火隹灬
矇	目豕
衒	彳亠亍
亶	亠囗旦
佺	亻人王
绖	纟至
赪	土贝
鲊	鱼乍
畤	田土寸
彿	彳弓
泚	氵止匕
愔	忄音
浬	氵里
麹	龶夂米
蓂	日六
鞬	革聿廴
豨	豕㐅巾
刬	戋刂
嚭	壴口口
堃	方方土
籥	⺮亼
詟	龙言
阇	门耂日
埗	土止
飐	⺇乂口
靺	革一木
扆	户衣
嗞	口䒑幺
悰	忄宀示
冇	冂
尪	尢王
崁	山土欠
擿	扌辶
牤	牜亡
祼	礻日木
罽	罒厂刂
崟	山金
抃	扌亠卜
邠	八刀阝
缊	纟日皿
曈	日立里
邽	土土阝
鞳	革艹口
亹	亠且
嵚	山钅欠
涴	氵宀㔾
沢	氵尸㇏
鞮	革日
旸	日ㄋ
洿	氵大丂
溦	氵山攵
瘆	疒厶彡
祎	礻韦
祲	礻彐又
霅	⻗言
亸	子十
卬	卩
垚	土土土
楯	木⺁目
欸	厶矢欠
沚	氵止
潾	氵米㐄
璘	王米㐄
菉	艹氺
眊	目毛
禋	礻覀土
袪	衤土厶
襕	衤门丷
俶	亻上又
倕	亻千二
夐	⺈夊
惛	忄日
曌	日月工
嶒	山曰
珺	王彐口
酺	酉甫
翚	羽冖车
瓘	王艹隹
皦	白白攵
乂	乂丶
蹐	⻊冫月
跱	⻊土寸
辀	车舟
僇	亻羽彡
鞨	革曰亾
鸰	亽龴鸟
骍	马辛
鹍	日匕鸟
磡	石力
诐	讠皮
鲹	鱼厶彡
龁	齿乙
盦	亽㇆皿
咍	口厶口
壸	一业
沄	氵云
皞	白白十
赑	贝贝贝
魋	鬼隹
窊	穴瓜
襜	衤⺈言
鄠	雨一阝
吽	口牛
恓	忄西
浐	氵厂
滉	氵日兀
琇	王禾乃
蹅	⻊木旦
傒	亻爫大
焜	火日匕
阘	门⺜羽
崚	山土夊
摛	扌文厶
镵	钅兔
唵	口大乚
抔	扌不
斝	吅冖十
梼	木寸
齁	自田句
弇	亼口廾
镮	钅罒
矻	石乙
鲯	鱼
鳣	鱼亠旦
厖	厂龙
姱	女大丂
忺	忄欠
晢	扌斤日
渰	氵亼廾
烜	火一旦
飔	⺇乂心
裛	巴
虓	九虎
嵎	山禺
饹	饣夂口
鲿	鱼龸云
婞	女土
昇	日丿廾
枲	厶口木
椓	木豕丶
毐	士毋
甪	丿用
踦	⻊大可
蒨	艹亻⺝
魆	鬼戉
潏	氵予口
瀼	氵亠
硙	石山己
璠	王丿田
嚚	吅臣吅
裈	衤冖车
逴	卜日辶
冏	冂八口
渟	氵丁
畬	亼朩田
郤	谷阝
鹖	曰勹鸟
碶	石丰大
榖	木殳
禘	礻巾
拃	扌乍
鳀	鱼日
鲬	鱼龴
舲	舟亽龴
隩	阝大
昉	日方
柈	木丷
椀	木宀㔾
牂	爿羊
郿	目阝
勍	小力
坰	土冂口
酂	⺧儿阝
缞	纟亠
绹	纟勹缶
锳	钅艹大
啫	口耂日
驲	马日
嫪	女羽彡
滃	氵八羽
饸	饣亼口
翾	罒羽
玦	王人
觱	戊用
诇	讠冂口
臑	月⻗而
縢	月糸
劄	⺮亼刂
尨	龙
岨	山且
崿	山吅丂
巉	山兔
帨	巾丷儿
槚	木覀贝
氿	氵九
熛	火覀示
枒	木牙
耑	山而
醾	酉麻米
巇	山虍戈
鹡	冫鸟
埆	土⺈用
筦	⺮宀兀
簃	⺮禾夕
蒻	艹弓冫
衎	彳干亍
俵	亻龶
靸	革乃丶
熇	火高
钖	钅ㄋ
麑	鹿臼儿
訚	门言
楙	木予木
媞	女日
鸧	人㔾鸟
崒	山亠十
硁	石ス工
谞	讠疋⺝
瑨	王一日
哢	口王廾
夬	人
峣	山兀
廋	广臼又
惙	忄又又
挦	扌彐寸
杻	木丑
棐	非木
欻	火火欠
氾	氵㔾
浡	氵子
爇	艹土灬
皛	白白白
嬅	女艹
翃	厶羽
簕	⺮革力
蔀	艹立阝
萩	艹禾火
荄	艹亥
糵	艹丿米
鬘	髟日又
蜎	虫口⺝
髎	骨羽彡
穟	禾丷辶
鄜	鹿阝
橦	木立里
沨	氵⺇乂
濩	氵艹又
屼	山兀
搒	扌方
醨	酉文厶
馌	饣土皿
掞	扌火火
昺	日𰀃人
杙	木弋
棓	木立口
棨	户攵木
洑	氵亻犬
洸	氵小兀
淏	氵旦大
畯	田厶夊
飗	⺇乂田
簠	⺮甫皿
跐	⻊止匕
蒐	艹鬼
芃	艹几丶
藟	艹田田
髽	髟人土
奓	大夕夕
伈	亻心
靿	革幺力
秬	禾匚コ
铏	钅一刂
锽	钅白王
粿	米日木
睎	目㐅巾
滆	氵鬲
澥	氵⺈牛
赟	文一贝
襚	衤丷辶
鳑	鱼方
鲏	鱼皮
鲗	鱼贝刂
翀	羽口丨
腯	月⺁目
镋	钅儿
剟	又又刂
墐	土革二
弢	弓屮又
暵	日廿夫
枹	木勹巳
溞	氵又虫
滪	氵予页
潟	氵臼灬
烺	火丶艮
瑑	王彑
瑳	王⺶工
踶	⻊日
赒	贝⺆口
赗	贝⺜目
蕰	艹氵皿
辌	小
蠋	虫罒虫
猰	犭丰大
鞡	革扌立
爚	火亼
镴	钅巛
镈	钅甫寸
橑	木大小
鹔	肀鸟
嫽	女大小
礌	石⻗田
忳	忄一
憺	忄⺈言
琭	王氺
瑢	王宀谷
璆	王羽彡
袆	衤韦
褕	衤亼刂
鹴	⻗木鸟
螣	月虫
肸	月八十
谿	爫幺谷
龂	齿斤
舠	舟刀
蒱	艹扌甫
偲	亻田心
儳	亻兔
叆	云又
孅	女人一
惔	忄火火
朳	木八
烔	火冂
狝	犭⺈小
琤	王⺈
琯	王宀㠯
疢	疒火
澴	氵罒
埼	土大可
墦	土丿田
簰	⺮片十
筥	⺮口口
羕	⺷丶
雊	句隹
茝	艹
黡	厂犬黑
伋	亻乃丶
纴	纟壬
觿	⺈用口
镠	钅羽彡
耇	耂句
昽	日龙
岠	山匚コ
疐	田疋
矰	矢曰
祃	礻马
韨	韦丶
彟	彐寸又
鳂	鱼田
腘	月囗丶
胠	月土厶
艎	舟白王
隃	阝亼刂
耰	耒丆夂
簉	⺮⺧辶
糒	米龷
讻	讠㐅凵
蓢	艹丶月
叇	云彐辶
嘚	口彳寸
噀	口巳八
坬	土瓜
埵	千二
慆	忄爫臼
棬	木
椑	木十
殣	歹革二
涘	氵厶矢
湉	氵忄舌
玃	犭目又
甦	一日生
郈	阝
蹜	⻊宀日
蔊	艹火干
辒	日皿
衠	彳十亍
蟫	虫覀十
鹙	禾火鸟
燏	火予口
绤	纟谷
铚	钅至
喤	口白王
慭	一米心
惎	心
馉	饣骨
饳	饣屮凵
珌	王心丿
鹯	亠囗鸟
敔	五口攵
鲌	鱼白
遹	予丿辶
臜	月⺧贝
朏	月屮凵
趯	走羽隹
陞	阝丿土
佽	亻冫欠
偓	亻尸至
偭	亻面
僰	木冂人
垞	土宀七
塅	土殳
嬿	女廿灬
帡	巾䒑廾
悢	忄丶艮
捯	扌至刂
斠	冉十
旐	方
昒	日勹
晫	日卜十
柷	木口儿
棁	木丷儿
洺	氵夕口
淜	氵月月
滫	氵⺝
澛	氵鱼日
焞	火子
璈	王龶攵
堨	土曰亾
虒	⺁虎
羖	⺶殳
鄫	曰阝
菂	艹白丶
蒟	艹立句
芼	艹毛
鬒	髟十
蝘	虫匚女
倞	亻小
偰	亻丰大
繄	匸矢糸
稌	禾亼朩
扊	户火火
煴	火日皿
镃	钅䒑幺
锧	钅⺁贝
咇	口心丿
姤	女
昈	日户
薢	艹⺈牛
湑	氵疋⺝
翙	山夕羽
岞	山乍
屃	尸贝
祏	礻石
禔	礻日
玚	王ㄋ
迺	西辶
邲	心丿阝
窎	穴鸟
讱	讠刀丶
鳠	鱼艹又
脿	月龶
疍	疋旦
蹢	⻊古
鞁	革皮
倓	亻火火
冮	冫工
勚	廿㇗力
奡	丆目
奭	大丆日
姞	女士口
娀	女戈
娵	女耳又
婘	女
媭	彡页女
嫄	女厂小
嫕	女匚心
孖	子子
庼	广匕页
忞	文心
晙	日厶夊
柊	木夂⺀
梿	木车辶
棫	木戈一
槱	木酉灬
汋	氵勹丶
浉	氵リ巾
瀍	氵广土
焗	火尸口
犨	隹隹牛
玘	王己
玡	王牙
琫	王
琲	王非
璪	王口木
皭	白爫寸
傢	亻宀豕
薿	艹匕疋
鄗	高阝
悆	亼朩心
埇	土龴
筀	⺮土土
羑	⺷㇏
踒	⻊禾女
蕗	艹⻊口
藠	艹白白
蘘	艹亠
萚	艹扌
髢	髟也
鸻	彳亍鸟
儦	亻鹿灬
猇	犭虎
匼	匸亼口
靰	革兀
鹀	工人鸟
鹒	广彐鸟
稑	禾土土
稙	禾十
甗	虍鬲瓦
扅	户夕夕
觭	⺈用可
镚	钅山月
嚄	口艹又
麀	鹿匕
骃	马因
骕	马肀八
梠	木口口
棽	木木㇆
榑	木甫寸
砮	女又石
弆	土厶廾
昫	日句
汧	氵一廾
漻	氵羽彡
嶓	山丿田
碃	石龶⺝
磹	石覀十
碨	石田
憭	忄大小
鬷	鬲㐅夊
玼	王止匕
圌	囗山而
袗	衤人彡
酦	酉丶
鳈	鱼白水
鲾	鱼田
腒	月尸古
盉	禾皿
鲖	鱼冂
祊	礻方
矼	石工
纼	纟弓丨
菼	艹火火
筤	⺮丶艮
耏	而彡
鸤	尸鸟
竫	立⺈
蟏	虫艹八
萹	艹户
蝲	虫束刂
侁	亻⺧儿
侂	亻广七
侘	亻宀七
偁	亻爫冉
傉	亻辰寸
劼	士口力
勔	面力
匜	匚也
哱	口子
啴	口丷十
噂	口丷寸
堉	土⺝
堲	卩土
妧	女一兀
婌	女上又
婼	女艹口
宬	宀戊㇆
峘	山一旦
崀	山丶艮
嵁	山㇗
嶲	山隹
弸	弓月月
摴	扌雨丂
昳	日丿夫
朓	月儿
杕	木大
桯	木口王
桹	木丶艮
楩	木亻
榰	木耂日
泙	氵干丷
泜	氵丶
湴	氵䒑业
漦	未攵水
漼	氵山隹
澼	氵尸辛
焌	火厶夊
爟	火艹隹
牁	爿可
狉	犭不一
猺	犭爫缶
獴	犭豕
珽	王壬廴
瑀	王丿冂
甡	生生
骉	马马马
囧	囗八冂
檵	木幺㇗
鹠	田鸟
塝	方
墈	土力
垕	土
黇	龷由口
鹟	八厶鸟
谼	谷龷八
葰	艹亻夊
蓇	艹骨
蓏	艹瓜瓜
薳	艹土辶
荖	艹耂匕
藦	艹麻手
葖	艹穴犬
莙	艹彐口
薁	艹大
轪	车大
螠	虫䒑皿
蚄	虫方
虸	虫子
伭	亻亠幺
佖	亻心丿
俙	亻㐅巾
儴	亻亠
攽	八刀攵
穜	禾立里
穄	禾示
觟	⺈用土
钘	钅一廾
铻	钅五口
鼫	鼠石
咥	口至
嘡	口土
耤	耒龷日
骙	马癶大
睄	目⺌⺝
姽	女⺈⺋
嬥	女羽隹
嬬	女⻗而
隺	冖隹
颋	壬廴页
旴	日一
晐	日亥
峗	山⺈⺋
峿	山五口
螱	尸示虫
磜	石示
硊	石⺈⺋
砫	石丶王
碏	石龷日
扺	扌七
玱	王人㔾
珷	王一止
琄	王口⺝
璲	王丷辶
郪	一阝
袯	衤丶
瓻	㐅瓦
鳁	鱼日皿
鲪	鱼彐口
鳛	鱼羽白
鱽	鱼刀
翂	羽八刀
艅	舟亼朩
襫	衤大日
鄅	丿虫阝
芣	艹不
靽	革丷
骦	马⻗目
靬	革干
荓	艹䒑廾
硿	石穴工
笯	⺮女又
衃	丿皿不
褟	衤⺜羽
砆	石夫
硍	石艮
蔈	艹覀示
礵	石⻗目
齇	自田且
丏	一丨㇆
伾	亻不一
俍	亻丶艮
倧	亻宀示
倴	亻大廾
僎	亻巳八
冔	⺜口
凓	冫覀木
剕	非刂
叚	二又
咡	口耳
咺	口一旦
垍	土自
婳	女一凵
媄	女⺷大
媆	女而大
媱	女爫缶
嫭	女虍
岊	巴山
峃	⺍冖山
峧	山六乂
嵲	山自木
幖	巾覀示
憙	壴口心
拤	扌上卜
摏	扌臼
敩	⺍冖攵
栟	木䒑廾
栻	木弋工
桲	木子
梴	木丿廴
梽	木士心
椸	木方也
欂	木艹寸
汭	氵冂人
沺	氵田
洴	氵䒑廾
浕	氵尸⺀
浰	氵禾刂
淟	氵
淴	氵勹心
澂	氵山攵
炟	火旦
烻	火丿廴
煟	火田⺝
牚	牙
玙	王丂一
玞	王夫
玭	王匕匕
珝	王羽
珫	王儿
瓖	王亠
蛃	虫𰀃人
揾	扌日皿
俬	亻禾厶
遆	巾辶
坋	土八刀
垎	土夂口
垯	土大辶
堎	土土夊
墣	土业夫
箖	⺮木木
筼	⺮口贝
筶	⺮⺧口
簝	⺮大小
筜	彐
鲝	⺶鱼
蹾	⻊攵
蹽	⻊大小
宧	宀
痓	疒至
菍	艹亽心
茽	艹亻丨
荙	艹大辶
茓	艹穴
蜐	虫土力
伣	亻见
侹	亻壬廴
俫	亻一米
猄	犭小
猯	犭山而
鞧	革丷酉
韂	革⺈言
弶	弓小
髃	骨禺
鄘	广肀阝
廆	广鬼
虤	虎虎
扂	户卜口
烶	火壬廴
翈	甲羽
缐	纟白水
斶	斤罒虫
訄	九言
鼩	鼠句
噇	口立里
竘	立句
麖	鹿小
枅	木一廾
梌	木亼朩
梾	木一米
榃	木木田
榅	木日皿
瞫	目覀十
妭	女丶
姶	女亼口
婍	女大可
婤	女⺆口
婫	女日匕
媂	女巾
媓	女白王
媖	女艹大
昡	日亠幺
晊	日至
泂	氵冂口
泃	氵句
洈	氵⺈⺋
溍	氵一日
漈	氵示
酅	山隹阝
崌	山尸古
嵅	山戊
嵖	山木旦
嶍	山羽白
嶦	山⺈言
砄	石人
祋	礻殳
禤	礻罒羽
祾	礻土夊
罶	罒田
扽	扌一
揳	扌丰大
疁	田羽彡
鹝	鬲鸟
玹	王亠幺
珸	王五口
瑂	王目
瑅	王日
瑔	王白水
瑝	王白王
瓀	王⻗而
釐	未攵里
郚	五口阝
歅	覀土欠
邘	一阝
鄑	一业阝
褯	衤广巾
厾	⺄土厶
鳡	鱼戊心
鱾	鱼己
鄃	亼⺝阝
勠	羽人力
霨	⻗尸寸
腨	月山而
脟	月爫寸
胈	月丶
鸼	舟鸟
鄀	艹阝
鼒	丿
辿	山辶
貆	豸一旦
莝	艹人土
羓	⺶巴
羱	⺶厂小
荁	艹一旦
鄌	广肀阝
砠	石且
蚆	虫巴
豮	豕十贝
陑	阝而
盷	目勹冫
翷	米夕羽
乸	也母
佁	亻厶口
佸	亻舌
倻	亻耳阝
偡	亻㇗
僔	亻丷寸
凘	冫斤
剅	豆刂
剋	古儿刂
呇	水口
哃	口冂
唝	口工贝
圐	囗罒方
圙	囗八面
圢	土丁
圲	土千
坒	匕匕土
坽	土亽龴
垙	土小兀
垵	土宀女
埌	土丶艮
埪	土穴工
堌	土囗古
堧	土而大
堼	土土土
堽	土罒止
墘	土十乙
妘	女云
姈	女亽龴
婻	女十
屾	山山
峂	山夂⺀
峱	犭丑山
崡	山乛凵
嶅	龶山
嶟	山丷寸
庤	广土寸
廙	广田八
悈	忄戈廾
愭	忄耂日
慥	忄⺧辶
慬	忄革二
憕	忄癶豆
戭	宀一戈
挓	扌宀七
旵	日山
旿	日十
昄	日⺁又
昤	日亽龴
昪	日厶廾
晅	日一旦
晱	日火火
暅	日忄旦
暕	日束丷
暲	日音十
杧	木亡
枍	木八丂
柖	木刀口
栐	木丶
栴	木亠
梣	木山㇆
椪	木䒑业
楪	木廿木
櫆	木鬼十
毌	毌一
汈	氵一
汫	氵井
沇	氵厶儿
沘	氵匕匕
洢	氵亻丿
洨	氵六乂
洭	氵匚王
浛	氵亽口
浟	氵攵
浭	氵一
浲	氵夂丰
涍	氵耂子
涐	氵手戈
涢	氵口贝
淯	氵⺝
渼	氵⺷大
湝	氵匕白
湣	氵民日
溇	氵米女
溚	氵艹口
溠	氵⺶工
溵	氵殳
滍	氵屮虫
漴	氵山示
漷	氵阝
漹	氵一灬
潖	氵王巴
潵	氵龷攵
潽	氵䒑日
澭	氵亠隹
瀔	氵殳
瀱	氵罒刂
灈	氵目隹
炌	火人
炣	火可
煁	火㇗
煃	火大土
熜	火心
熥	火龴辶
熻	火亼羽
燚	火火火
爔	火⺷戈
牥	牜方
玒	王工
玓	王勹丶
玶	王干丷
玿	王刀口
珇	王且
珒	王聿
珕	王力力
珖	王小兀
珦	王口
珵	王口王
珹	王戊
琀	王亽口
琎	王井辶
琔	王宀疋
琟	王隹
琡	王上又
瑃	王日
瑆	王日生
瑖	王殳
瑬	氵丶
璒	王癶豆
璥	王艹攵
璬	王白攵
畖	田瓜
疭	疒人人
癗	疒⻗田
皕	丆日日
砵	石木一
膙	月弓虫
萳	艹十
蔃	艹弓虫
薸	艹氵示
觃	见子
陎	阝丿未
齉	自田
慓	忄覀示
琍	王禾刂
蠧	石虫
歔	虍业欠
誌	言士心
砢	石可
頔	由页
娭	女厶矢
嘢	口里予
袴	衤大丂
毑	母也
觍	见
坉	土一
䣘	土阝
鹐	⺈臼鸟
䢼	龷八阝
䎖	日羽
戣	癶一戈
葴	艹戊
苧	艹宀丁
莿	艹木刂
蒄	一寸
䓨	缶
䓫	艹大可
徛	彳大可
虷	虫干
鬶	夫见鬲
㺄	犭亼刂
旞	方辶
庱	广土夊
馧	禾日皿
穙	禾业夫
馝	禾日丿
䅟	禾厶彡
焆	火口⺝
煓	火山而
䌹	纟冂口
䥽	钅丶
鼱	鼠龶⺝
䶮	龙一大
鄚	䒤大阝
㭕	木土厶
棤	木龷日
椆	木⺆口
檞	木⺈牛
㛚	女龴
䢺	屮凵阝
䴖	龶⺝鸟
昣	日人彡
瀌	氵鹿灬
饻	饣衣
硔	石龷八
㥄	忄土夊
邿	土寸阝
璮	王亠旦
鳤	鱼⺮㠯
鲘	鱼
翯	羽高
舥	舟巴
碈	石日
禒	礻彑
胣	月也
㑇	亻⺈彐
㑊	亻亦
㕮	口八乂
㘎	口门攵
㙍	土又又
㙘	土覀女
㙦	亼朩土
㛃	丰刀女
㛹	女亻
㟃	山
㠇	山尤
㠓	山豕
㤘	忄⺈彐
㧐	扌又又
㧑	扌丶丶
㧟	扌氵匚
㫰	日丶艮
㬊	日爫又
㬎	日幺灬
㬚	日攵
㭎	木冂㐅
㮾	丶木
㰀	木禾水
㳇	氵八乂
㳘	氵儿
㳚	氵戊丶
㴔	氵⺈心
㵐	氵厂欠
㶲	火用
㸆	火⺧非
㸌	火⻗隹
㻬	王雨丂
㽏	氵亼甘
㿠	白小兀
䁖	目米女
䂮	丰刀石
䃅	石丷十
䃎	石大夕
䎃	冉羽
䏝	月二丶
䏡	月示
䏲	月丷
䐃	月囗禾
䓖	艹穴力
䓛	艹尸凵
䓬	艹卜十
䕫	艹白夊
䗖	虫巾
䗛	虫⺝
䗪	广廿虫
䗴	虫⺮廴
䜣	讠斤
䝙	豸匸㐅
䦃	钅艹日
䲟	鱼卩
䲠	鱼日
䲢	月鱼
䴓	一巾鸟
䴔	六乂鸟
䴕	歹刂鸟
䴗	目犬鸟
䴘	⺁虎鸟
䴙	尸口鸟
侴	亼丑刂
傃	亻龶糸
叕	又又又
咉	口大
圫	土丿七
坥	土且
垈	亻弋土
垏	土聿
垺	土爫子
垾	土日干
垿	土广予
埫	土尚
堐	土厂土
堾	日
塱	丶土
墕	土一灬
墡	土羊口
寁	宀一龰
峏	山而
峛	山歹刂
崶	山土寸
弨	弓刀口
恔	忄六乂
愃	忄宀旦
愐	忄面
揕	扌㇗
晪	日
暶	日方疋
暿	日壴口
朸	木力
杄	木千
栒	木勹日
棪	木火火
楒	木田心
槜	木隹乃
橞	木惠心
泇	氵力口
洓	氵木冂
洘	氵耂丂
洣	氵米
涄	氵由丂
溁	氵木
溹	氵糸
滧	氵六攵
漋	氵阝生
漖	氵耂攵
潩	氵田八
澪	氵⻗龴
澽	氵虍豕
濋	氵木疋
烠	火⺝
煋	火日生
牻	牜龙
玤	王丰
珋	王卯
珛	王⺝
珢	王艮
琈	王爫子
瑓	王束丷
瑧	王禾
璱	王王丿
癿	白乚ㄋ
苉	艹匸儿
茋	艹丶
萣	艹宀疋
蚲	虫干丷
馞	禾日子
鹲	一鸟
粬	米曲
𬉼	火匸㐅
𠳐	口阝
𥻗	米木旦
𠙶	凵了
𬣙	讠一
𨙸	十又阝
𬇕	氵一
𬣞	讠宀一
𬘓	纟川
𫭟	土匸㐅
𫭢	土人匕
𫇭	艹丶丶
𫐄	车兀
𫵷	山厂力
𣲘	氵无
𣲗	氵韦
𬇙	氵贝
𬣡	讠戋
𫸩	弓匸㐅
𨚕	厶廾阝
𫘜	马文
𬘘	纟冖
𫘝	马人
𦭜	⺿口八
𬨂	车七
𬀩	日韦
𬀪	日见
𬬩	钅弋
𫍣	讠冂
𬣳	讠艮
𬩽	彐寸阝
𬮿	阝山己
𬯀	阝文
𫰛	女ス工
𬳵	马不一
𬳶	马冂口
𫠊	马亠幺
𬍛	王小
鿍	土夂㐄
𬜬	艹门口
𦰡	⺿阝
𪾢	目见
𪨰	山曲
𫓧	钅夫
𬬮	钅长
𬬱	钅斤
𬬭	钅人匕
𦙶	月古
𬘡	纟因
𬳽	马⺧儿
𬘩	纟壬廴
𪟝	龶贝力
𬍤	王彐寸
𫭼	土力
𬜯	艹𰀃人
𬂩	木一大
𫠆	十又页
𨐈	车小兀
𬌗	牙亼口
𫑡	黾阝
𪨶	山大车
𬬸	钅木丶
𬬻	钅卜尸
𬬹	钅申
𬬿	钅刀口
𬭁	钅母
𫢸	亻丷十
𫗧	饣束
𬊈	火彐寸
𬒈	⺍冖石
𨺙	阝臼儿
𬳿	马亼朩
𫄨	纟㐅巾
𬘫	纟宀兀
𫮃	土丷十
鿎	石大辶
𬱖	由页
𬟽	虫小
𫓯	钅土土
𫟹	钅龷八
𫟼	钅大辶
𠅤	亠田心
𬇹	氵囗丶
𬍡	氵ㄋ丶
𬤇	讠覀土
𫍯	讠戊
𬤊	讠日
𫍲	讠臼又
𬯎	阝贝
𬘬	纟龶⺝
𬘭	纟木木
𬴂	马非
𫘦	马勹缶
𫟅	纟小
𬘯	纟子
𫘧	马氺
𪣻	土米女
𡎚	土户
𬃊	木⺁贝
𬷕	甫鸟
𫐐	车臼儿
𬹼	齿人
𧿹	⻊母
𫶇	山巾
𫖮	山己页
鿏	钅龶夂
𬭊	钅木土
𨱇	钅一丶
𫓶	钅口⺝
𬭎	钅宀厶
𫖯	儿冫页
𬱟	⺈厂页
𫛭	犭王鸟
𫷷	广钅欠
𬮱	门覀土
𬊤	火丷十
𣸣	氵十贝
𬴃	马丰石
𫘨	马日
𤧛	王巾
𬪩	酉冖
𬒔	石止⺝
𬨎	车丷酉
𫐓	车予木
𫫇	口一心
𫓹	钅
𬭚	钅子
𬭛	钅氵皮
𬕂	⺮工贝
𬶋	鱼句
𬶍	鱼宀匕
𦝼	月米女
𫔶	门自木
𫌀	衤龶贝
𫖳	彐丿页
𫘪	马厂小
𫘬	马爫大
𫞩	王艹人
𡐓	土广水
𪤗	土羽彡
𣗋	木儿
𬸘	匸日鸟
𬒗	石〢见
𥔲	石吅丂
𫚖	止匕鱼
𨱏	钅艹口
𬭤	钅亻矢
𫚕	鱼リ巾
𬶐	鱼儿
𬶏	鱼⺈⺋
𩽾	鱼宀女
𬸚	犭讠鸟
𬤝	讠惠心
𬙂	纟宀八
𬭩	钅八羽
𩾃	鱼
𬸣	𡨄鸟
𫍽	讠罒
𬴊	马米㐄
𬞟	艹止页
𥕢	石一曰
𫟦	车丷辶
𬺈	齿大可
𫠜	齿臼儿
𪩘	山十犬
𬭬	钅丰彐
𨱑	钅龷八
𬭯	钅㡀攵
𫗴	饣亠旦
𬸦	方鸟
𫄷	纟音心
𤩽	王十犬
𬭳	钅壴口
𬭶	钅黑
𫔍	钅丿田
𬭸	钅米㐄
𨱔	钅丷寸
𬭼	钅丷辶
𫔎	钅予口
𬸪	丿米鸟
𬶟	鱼束刂
𬶠	鱼束丷
𬶨	旡鱼
𦈡	纟⻗而
𫄸	纟千黑
𬟁	艹鬲鸟
𥖨	石口木
𦒍	立里羽
𬙊	纟黑土
𬶭	鱼示
𩾌	鱼广水
𨟠	目目阝
𬶮	鱼壴口
𨭉	文一金
𬙋	纟亠
𤫉	王言又
𬺓	齿木疋
𫚭	鱼巛
屄	尸穴
逎	酉辶
